production_day,component_name,component_id,line,produced,output_good,scrap,scrap_imm,scrap_deco
2021-10-20,SD,13,PL20,71270,71147,789,640,149
2021-11-13,PR,15,PL04,264704,264672,832,832,0
2021-01-09,SD,13,PL25,72525,71996,792,192,600
2021-06-22,RT,21,PL05,13872,13848,288,288,0
2021-01-18,DI,19,PL53,296128,296576,352,352,0
2021-02-18,PB,25,PL55,448064,447584,1024,1024,0
2021-11-02,HO,18,PL03,45560,45360,200,200,0
2021-08-13,PR,15,PL12,124800,124432,368,368,0
2021-07-29,CL,14,PL44,298528,296896,2144,2144,0
2021-06-01,CL,14,PL45,284160,275296,6912,6912,0
2021-10-14,HO,18,PL33,132336,132432,0,0,0
2021-03-08,PW,26,PL37,812112,809856,2784,2784,0
2021-03-28,CL,14,PL44,184032,166368,12352,12352,0
2021-07-21,PB,25,PL55,450432,450208,1184,1184,0
2021-10-01,RA,17,PL35,103704,97128,6576,6576,0
2021-10-09,CA,23,PL02,229728,229968,552,552,0
2021-07-22,HO,18,PL33,66032,66000,112,112,0
2021-09-04,PRG,12,PL14,391840,390112,2016,2016,0
2021-03-06,SD,13,PL22,72376,72272,632,528,104
2021-11-01,CH,24,PL08,130966,106711,31707,7392,24315
2021-08-08,CL,14,PL44,296032,292960,2176,2176,0
2021-04-25,SD,13,PL20,76397,76186,387,176,211
2021-07-05,SB,11,PL36,8568,8568,0,0,0
2021-01-05,SD,13,PL20,66564,66244,1175,832,343
2021-03-18,SD,13,PL19,67019,66444,2248,1632,616
2021-04-10,CH,24,PL08,301254,291847,15211,5344,9867
2021-10-31,HO,18,PL33,132464,132464,0,0,0
2021-12-04,HO,18,PL30,48144,47024,1120,1120,0
2021-10-06,SB,11,PL50,256896,239520,17376,17376,0
2021-09-26,SB,11,PL50,353184,350592,3424,3424,0
2021-01-18,HO,18,PL01,65752,65752,104,104,0
2021-12-21,SD,13,PL21,74032,73541,882,368,514
2021-03-19,CA,23,PL13,84536,84496,160,160,0
2021-07-02,CA,23,PL11,235752,234360,1392,1392,0
2021-12-11,SD,13,PL19,65418,64388,1222,192,1030
2021-03-10,SD,13,PL20,76332,76068,632,368,264
2021-04-21,SD,13,PL20,67616,67393,931,720,211
2021-10-25,SD,13,PL21,63643,63478,581,368,213
2021-04-27,SD,13,PL22,65834,65090,1397,624,773
2021-04-03,HO,18,PL33,39848,39632,216,216,0
2021-12-14,HO,18,PL33,72112,71704,480,480,0
2021-09-30,PR,15,PL24,265792,264608,1312,1312,0
2021-04-10,RT,21,PL06,205944,205656,720,720,0
2021-08-05,SD,13,PL19,51543,51485,929,816,113
2021-09-23,SB,11,PL50,461760,461152,1120,1120,0
2021-03-20,PW,26,PL37,571488,540576,31296,31296,0
2021-07-15,PR,15,PL12,139632,139664,176,176,0
2021-02-07,SD,13,PL19,64433,63528,1321,416,905
2021-03-14,RT,21,PL42,149440,137696,11888,11888,0
2021-03-13,HO,18,PL32,67776,67656,120,120,0
2021-06-25,HO,18,PL32,67968,67936,104,104,0
2021-09-14,SB,11,PL36,277488,266712,11208,11208,0
2021-02-09,HO,18,PL30,62048,61960,88,88,0
2021-11-05,CA,23,PL13,74136,73304,920,920,0
2021-03-23,PR,15,PL24,232992,228544,4832,4832,0
2021-09-30,RT,21,PL06,42600,42840,0,0,0
2021-01-09,RT,21,PL06,207792,207744,288,288,0
2021-09-04,CH,24,PL57,27492,27484,72,72,0
2021-01-22,SD,13,PL20,71142,71022,1384,1264,120
2021-03-12,HO,18,PL01,66128,65992,208,208,0
2021-11-05,CL,14,PL45,262048,253184,7776,7776,0
2021-08-11,RT,21,PL05,205392,204984,552,552,0
2021-02-14,RT,21,PL05,209592,209736,0,0,0
2021-04-29,PW,26,PL37,806448,805776,3456,3456,0
2021-06-15,SD,13,PL17,72000,70771,2285,976,1309
2021-11-07,HO,18,PL56,65032,64992,104,104,0
2021-04-29,RA,17,PL35,215424,211776,4008,4008,0
2021-11-24,CA,23,PL02,235800,235032,1032,1032,0
2021-06-11,RT,21,PL42,141408,128896,12512,12512,0
2021-09-08,SD,13,PL21,75089,74737,605,240,365
2021-11-29,CH,24,PL24,162384,161792,736,736,0
2021-10-10,HO,18,PL03,54008,53928,80,80,0
2021-09-07,RT,21,PL05,205968,205344,888,888,0
2021-10-05,DI,19,PL52,287360,287168,608,608,0
2021-02-04,NT,16,PL51,471136,470688,1056,1056,0
2021-02-11,RT,21,PL42,159888,157712,2544,2544,0
2021-10-20,RA,17,PL34,259704,259128,984,984,0
2021-12-06,SB,11,PL36,309624,308976,1752,1752,0
2021-05-31,SD,13,PL21,59415,57089,2995,576,2419
2021-05-26,EC,10,PL43,613680,611328,2256,2256,0
2021-07-14,RT,21,PL05,187272,186528,984,984,0
2021-09-22,RT,21,PL05,204984,204336,1032,1032,0
2021-10-13,SD,13,PL21,65226,64946,648,368,280
2021-01-23,SD,13,PL18,73107,72945,530,368,162
2021-06-03,SD,13,PL22,67451,66832,811,192,619
2021-08-17,CH,24,PL12,0,0,208,208,0
2021-08-12,HO,18,PL11,66280,66280,0,0,0
2021-07-23,PR,15,PL12,41152,38064,3120,3120,0
2021-12-15,SB,11,PL36,223080,221640,4608,4608,0
2021-08-30,PR,15,PL04,255392,254624,1216,1216,0
2021-04-25,SD,13,PL17,65824,65543,1705,1424,281
2021-07-31,PB,25,PL54,442208,437440,5344,5344,0
2021-12-02,CH,24,PL57,34060,34028,96,96,0
2021-02-25,RT,21,PL41,13952,10160,3792,3792,0
2021-02-19,CA,23,PL31,105720,97968,7752,7752,0
2021-02-04,RA,17,PL35,168504,165648,3120,3120,0
2021-05-07,EC,10,PL43,180112,179872,192,192,0
2021-12-05,PR,15,PL24,236096,235072,864,864,0
2021-09-19,CH,24,PL07,166691,160668,21354,10688,10666
2021-01-15,PR,15,PL24,267808,267872,224,224,0
2021-03-29,HO,18,PL11,66288,66288,0,0,0
2021-01-02,SD,13,PL19,31475,31401,335,176,159
2021-08-28,SD,13,PL19,74733,74690,587,544,43
2021-10-18,SD,13,PL22,66834,66726,300,192,108
2021-11-16,HO,18,PL11,59904,59568,336,336,0
2021-11-04,HO,18,PL33,132432,132288,176,176,0
2021-04-23,DI,19,PL52,247520,248064,0,0,0
2021-03-24,HO,18,PL10,57472,57232,240,240,0
2021-08-18,HO,18,PL01,0,0,0,0,0
2021-09-16,EC,10,PL43,605904,598176,7440,7440,0
2021-03-27,SB,11,PL50,367904,366624,2240,2240,0
2021-06-15,CH,24,PL57,23812,23724,88,88,0
2021-06-29,RA,17,PL34,220104,219360,936,936,0
2021-08-10,RT,21,PL42,91600,89888,2976,2976,0
2021-02-10,PRG,12,PL12,389280,389024,1632,1632,0
2021-02-27,HO,18,PL33,15672,15128,544,544,0
2021-05-29,RT,21,PL42,186272,159296,29072,29072,0
2021-07-07,HO,18,PL03,67040,67008,88,88,0
2021-07-17,HO,18,PL40,57104,54432,2672,2672,0
2021-03-30,RT,21,PL41,4528,4384,2320,2320,0
2021-12-20,PB,25,PL54,432832,410912,23136,23136,0
2021-09-03,DI,19,PL53,296704,296512,576,576,0
2021-03-15,RT,21,PL06,203328,202608,1224,1224,0
2021-05-08,SD,13,PL18,73949,73808,509,368,141
2021-05-17,CA,23,PL31,108000,105408,2592,2592,0
2021-03-05,RA,17,PL34,219144,218568,576,576,0
2021-12-15,PB,25,PL55,202720,198240,5344,5344,0
2021-09-19,HO,18,PL10,68576,68528,96,96,0
2021-07-11,SD,13,PL25,39539,39250,1187,640,547
2021-06-05,CH,24,PL07,301248,280651,24864,4192,20672
2021-02-08,RA,17,PL35,218040,216624,1416,1416,0
2021-06-23,CA,23,PL11,186048,184320,2112,2112,0
2021-06-03,RA,17,PL35,1608,1608,0,0,0
2021-06-29,CH,24,PL07,279475,266785,19186,6496,12690
2021-05-20,RA,17,PL56,177624,176640,984,984,0
2021-04-30,PR,15,PL04,259968,259776,640,640,0
2021-10-01,NT,16,PL51,499104,496416,3328,3328,0
2021-07-17,PB,25,PL55,447488,446240,2208,2208,0
2021-01-04,RA,17,PL34,179400,178248,2328,2328,0
2021-03-04,RT,21,PL06,125712,122976,5544,5544,0
2021-07-14,SD,13,PL20,75049,74931,470,352,118
2021-01-25,SD,13,PL19,60797,60428,561,192,369
2021-01-04,HO,18,PL01,40360,39224,1256,1256,0
2021-11-02,EC,10,PL43,621408,620880,528,528,0
2021-04-23,SD,13,PL22,66338,65755,1127,544,583
2021-02-18,PRG,12,PL14,297728,282848,14880,14880,0
2021-05-29,HO,18,PL10,57056,56704,376,376,0
2021-10-27,SB,11,PL50,432096,409664,22560,22560,0
2021-10-12,RT,21,PL42,6272,1408,4864,4864,0
2021-03-25,HO,18,PL32,67496,67320,176,176,0
2021-11-23,PRG,12,PL14,396576,396992,128,128,0
2021-08-23,SD,13,PL19,68555,68517,647,592,55
2021-02-20,RA,17,PL34,220032,219840,408,408,0
2021-09-04,RA,17,PL35,231408,230856,552,552,0
2021-03-29,HO,18,PL03,65736,65440,296,296,0
2021-11-15,SD,13,PL17,70196,70139,313,176,137
2021-06-07,PB,25,PL55,144896,144480,1280,1280,0
2021-10-29,DI,19,PL52,77088,77088,0,0,0
2021-11-01,PB,25,PL55,0,0,0,0,0
2021-01-15,HO,18,PL01,61984,61984,280,280,0
2021-01-14,EC,10,PL43,465984,457968,8592,8592,0
2021-05-30,CH,24,PL57,34272,34232,40,40,0
2021-03-19,SB,11,PL50,5472,0,5472,5472,0
2021-08-28,HO,18,PL03,67608,67608,0,0,0
2021-06-27,SD,13,PL21,68837,68462,1188,768,420
2021-08-28,SD,13,PL20,73705,73693,1494,1440,54
2021-04-12,CA,23,PL31,22944,9456,13488,13488,0
2021-10-29,CH,24,PL12,55152,55152,0,0,0
2021-01-27,PW,26,PL37,600960,585648,15696,15696,0
2021-11-04,HO,18,PL56,65504,65224,328,328,0
2021-06-02,RT,21,PL05,204216,204192,1560,1560,0
2021-11-09,HO,18,PL01,68128,67896,232,232,0
2021-12-07,PR,15,PL04,263360,262912,928,928,0
2021-10-07,HO,18,PL03,66664,66600,184,184,0
2021-02-22,RA,17,PL56,220536,219960,576,576,0
2021-04-06,HO,18,PL11,62136,62008,128,128,0
2021-11-07,HO,18,PL10,69400,69392,8,8,0
2021-04-09,SD,13,PL18,56466,55722,1768,1024,744
2021-05-09,SB,11,PL50,290496,286240,4992,4992,0
2021-03-07,SB,11,PL50,451744,451200,1728,1728,0
2021-01-25,SB,11,PL50,442816,436224,8064,8064,0
2021-05-25,PR,15,PL04,256608,254784,2432,2432,0
2021-03-27,SD,13,PL19,53522,52841,4505,3824,681
2021-05-12,CA,23,PL02,221952,220944,1752,1752,0
2021-10-14,CA,23,PL02,232416,230856,1560,1560,0
2021-11-01,HO,18,PL33,130480,129552,1024,1024,0
2021-11-28,HO,18,PL10,67136,66968,200,200,0
2021-12-07,CA,23,PL31,208704,207816,936,936,0
2021-07-08,CH,24,PL08,298915,280868,28481,10432,18049
2021-11-30,PB,25,PL55,449024,449568,1120,1120,0
2021-07-01,SB,11,PL50,456896,455520,3104,3104,0
2021-08-21,HO,18,PL03,61480,61104,376,376,0
2021-04-22,PR,15,PL24,265216,261600,3968,3968,0
2021-06-18,SD,13,PL18,55910,55436,4922,4416,506
2021-10-22,HO,18,PL09,66744,66376,384,384,0
2021-02-26,HO,18,PL30,5016,5008,96,96,0
2021-09-09,CL,14,PL45,251680,233696,10688,10688,0
2021-01-30,CA,23,PL31,233064,231048,2112,2112,0
2021-06-18,PR,15,PL04,258336,246912,11584,11584,0
2021-03-29,SD,13,PL17,50402,50086,1068,752,316
2021-06-26,SD,13,PL25,75616,75050,980,384,596
2021-05-19,HO,18,PL32,64040,63864,176,176,0
2021-03-20,PR,15,PL24,238304,229216,9440,9440,0
2021-12-02,HO,18,PL33,69312,69216,96,96,0
2021-04-16,SB,11,PL50,326368,323232,5856,5856,0
2021-10-03,PW,26,PL37,809904,810672,4896,4896,0
2021-04-05,HO,18,PL09,72800,72800,0,0,0
2021-12-13,CH,24,PL08,134500,96879,47580,9600,37980
2021-03-15,NT,16,PL51,469792,469856,384,384,0
2021-09-14,CH,24,PL57,34164,34156,48,48,0
2021-02-18,HO,18,PL33,67960,67800,208,208,0
2021-07-03,DI,19,PL52,287232,286240,1120,1120,0
2021-01-18,PR,15,PL04,261792,258304,3936,3936,0
2021-03-26,HO,18,PL32,31976,31888,208,208,0
2021-06-12,CA,23,PL31,109464,105720,3744,3744,0
2021-04-22,CH,24,PL07,0,0,3529,2400,1129
2021-08-07,CL,14,PL45,293344,289792,2336,2336,0
2021-07-26,SD,13,PL20,73600,73524,476,400,76
2021-12-14,CH,24,PL08,573,246,327,0,327
2021-04-27,SD,13,PL20,71665,71454,747,528,219
2021-06-22,EC,10,PL43,627072,625776,1152,1152,0
2021-10-30,PB,25,PL54,381088,369184,24224,24224,0
2021-02-07,RA,17,PL34,199968,199656,288,288,0
2021-05-21,CH,24,PL12,153408,150784,2992,2992,0
2021-12-03,SB,11,PL50,424736,424096,1088,1088,0
2021-06-23,SD,13,PL19,76099,76152,34,0,34
2021-01-23,RA,17,PL35,219000,218880,792,792,0
2021-07-22,CA,23,PL31,135144,134160,984,984,0
2021-04-02,HO,18,PL30,63440,63392,112,112,0
2021-09-27,SD,13,PL18,74449,73604,1229,384,845
2021-11-02,DI,19,PL52,176352,173760,2592,2592,0
2021-06-28,HO,18,PL30,52880,52760,120,120,0
2021-10-09,DI,19,PL53,297920,298048,0,0,0
2021-10-13,DI,19,PL52,264288,262880,1856,1856,0
2021-09-05,HO,18,PL10,68424,68328,96,96,0
2021-06-28,EC,10,PL43,262224,260112,4464,4464,0
2021-03-13,RA,17,PL34,133368,126096,7272,7272,0
2021-06-10,RA,17,PL35,215232,206808,8424,8424,0
2021-01-11,RT,21,PL05,200112,197712,2808,2808,0
2021-11-12,SD,13,PL19,72992,72761,600,352,248
2021-05-10,DI,19,PL53,290304,289280,1312,1312,0
2021-08-01,HO,18,PL33,66216,66224,0,0,0
2021-04-17,SD,13,PL19,55654,55562,460,368,92
2021-02-04,DI,19,PL52,220576,220672,1856,1856,0
2021-11-05,HO,18,PL09,67216,66944,280,280,0
2021-12-10,PB,25,PL55,449504,448704,1760,1760,0
2021-04-27,NT,16,PL51,165632,164832,800,800,0
2021-10-10,HO,18,PL11,66264,66168,96,96,0
2021-10-20,CA,23,PL31,231792,231888,384,384,0
2021-10-14,RT,21,PL42,29104,17024,12080,12080,0
2021-07-30,RT,21,PL42,180864,178480,3984,3984,0
2021-07-04,HO,18,PL09,71856,71968,120,120,0
2021-12-11,HO,18,PL10,68904,68808,96,96,0
2021-04-19,SD,13,PL25,941,850,347,256,91
2021-01-28,HO,18,PL33,66744,66704,96,96,0
2021-05-14,CH,24,PL08,295114,286159,28319,19232,9087
2021-06-20,SD,13,PL21,75243,74777,1151,624,527
2021-07-27,HO,18,PL33,64968,64920,120,120,0
2021-01-02,HO,18,PL33,50936,50872,64,64,0
2021-02-27,HO,18,PL09,67440,67296,488,488,0
2021-05-10,CH,24,PL57,34164,34136,44,44,0
2021-04-16,PR,15,PL04,263424,263168,800,800,0
2021-02-12,SD,13,PL21,65891,64746,1688,448,1240
2021-10-24,RA,17,PL35,264864,263712,1296,1296,0
2021-03-02,RT,21,PL05,205152,204120,1104,1104,0
2021-05-17,PB,25,PL55,291648,278688,16128,16128,0
2021-08-17,HO,18,PL40,22384,22360,24,24,0
2021-02-16,PR,15,PL24,193536,188608,5088,5088,0
2021-02-14,SD,13,PL19,28556,28378,1250,1072,178
2021-06-14,DI,19,PL52,256928,256160,2464,2464,0
2021-05-10,SD,13,PL22,73245,72895,1806,1456,350
2021-10-03,SD,13,PL17,74143,73746,1037,640,397
2021-05-09,SD,13,PL20,76199,75994,381,176,205
2021-03-11,RT,21,PL06,177000,175296,1704,1704,0
2021-03-13,DI,19,PL53,278304,277408,1312,1312,0
2021-03-11,HO,18,PL09,34888,34432,456,456,0
2021-01-31,HO,18,PL30,65536,65400,136,136,0
2021-03-08,HO,18,PL03,66208,66040,168,168,0
2021-10-11,SD,13,PL25,4021,3998,32,0,32
2021-07-05,SD,13,PL22,6362,6357,67,48,19
2021-03-04,RT,21,PL42,107152,103008,5168,5168,0
2021-05-22,SD,13,PL20,46271,46075,2484,2288,196
2021-01-13,RT,21,PL05,202728,202392,1032,1032,0
2021-07-22,HO,18,PL09,9008,9008,0,0,0
2021-03-16,SD,13,PL20,75897,75659,1103,752,351
2021-03-06,CL,14,PL45,105920,93120,11584,11584,0
2021-04-24,CA,23,PL13,85712,85624,144,144,0
2021-11-05,EC,10,PL43,624240,623424,624,624,0
2021-10-24,HO,18,PL11,66144,66136,104,104,0
2021-03-24,PRG,12,PL14,362304,342176,22496,22496,0
2021-07-26,PW,26,PL37,664224,620880,43776,43776,0
2021-01-02,CA,23,PL02,137448,134472,3240,3240,0
2021-12-06,RT,21,PL41,256,0,256,256,0
2021-10-04,CH,24,PL12,164816,164720,208,208,0
2021-10-07,SD,13,PL17,74864,74701,553,352,201
2021-10-05,SD,13,PL17,67886,67724,999,832,167
2021-11-20,HO,18,PL40,66320,66320,0,0,0
2021-04-24,RT,21,PL06,208248,207840,408,408,0
2021-08-01,RT,21,PL05,205584,202008,3696,3696,0
2021-11-15,SD,13,PL18,75388,74824,795,208,587
2021-03-26,HO,18,PL10,46552,46408,400,400,0
2021-08-13,RT,21,PL06,0,0,0,0,0
2021-01-22,RT,21,PL05,205272,204096,1344,1344,0
2021-06-04,HO,18,PL09,59912,59784,128,128,0
2021-05-09,SB,11,PL36,276744,270792,6408,6408,0
2021-08-28,CH,24,PL08,308799,304109,8021,3264,4757
2021-04-23,CL,14,PL45,0,0,0,0,0
2021-07-01,RT,21,PL42,186384,177040,9504,9504,0
2021-01-30,SD,13,PL17,16929,16713,955,736,219
2021-06-22,NT,16,PL51,513568,507136,7232,7232,0
2021-05-25,HO,18,PL40,4896,4768,128,128,0
2021-02-25,CL,14,PL44,296672,283872,3200,3200,0
2021-03-16,NT,16,PL57,105440,103936,1552,1552,0
2021-04-27,HO,18,PL40,23096,22992,104,104,0
2021-09-04,NT,16,PL51,509376,508544,1184,1184,0
2021-02-04,PRG,12,PL14,377472,374880,2592,2592,0
2021-09-08,RT,21,PL42,172240,170864,2320,2320,0
2021-11-01,RA,17,PL35,259464,257160,2304,2304,0
2021-09-28,RT,21,PL06,203976,204072,480,480,0
2021-10-24,CH,24,PL07,304882,298822,9452,3392,6060
2021-11-18,CA,23,PL13,85088,84672,448,448,0
2021-05-11,CH,24,PL08,260321,251752,21899,11872,10027
2021-11-15,CA,23,PL13,84688,84048,720,720,0
2021-05-19,HO,18,PL01,55552,54872,888,888,0
2021-09-18,CL,14,PL45,285728,283648,1536,1536,0
2021-05-19,CH,24,PL57,34216,34188,48,48,0
2021-01-29,SD,13,PL17,68562,68314,424,176,248
2021-12-02,CA,23,PL13,83424,83336,256,256,0
2021-01-18,SD,13,PL20,75723,75593,720,576,144
2021-02-17,SD,13,PL21,72702,71868,1234,384,850
2021-05-26,RA,17,PL56,220584,220008,648,648,0
2021-09-06,PR,15,PL24,265920,265984,32,32,0
2021-06-04,CH,24,PL57,34156,34112,44,44,0
2021-09-01,SD,13,PL17,68796,68489,3619,3312,307
2021-03-11,HO,18,PL33,5784,5784,0,0,0
2021-01-10,RA,17,PL34,215496,214152,1680,1680,0
2021-09-06,NT,16,PL51,512384,513088,384,384,0
2021-11-12,HO,18,PL11,65760,65608,152,152,0
2021-03-21,HO,18,PL03,64888,64376,512,512,0
2021-11-30,CA,23,PL31,148608,148008,1776,1776,0
2021-09-28,SB,11,PL50,429600,425792,4192,4192,0
2021-04-10,PB,25,PL55,448416,446464,3168,3168,0
2021-06-13,CL,14,PL44,298976,295456,2720,2720,0
2021-06-07,HO,18,PL03,936,0,936,936,0
2021-02-15,RT,21,PL06,204696,204648,432,432,0
2021-06-18,EC,10,PL43,629232,626496,3024,3024,0
2021-01-19,PR,15,PL24,265248,264128,1280,1280,0
2021-10-18,EC,10,PL43,622752,622368,576,576,0
2021-03-19,CA,23,PL02,208896,201072,8160,8160,0
2021-07-05,EC,10,PL43,384144,383808,192,192,0
2021-03-16,EC,10,PL43,0,0,38400,38400,0
2021-11-16,SD,13,PL18,75573,75248,798,368,430
2021-08-17,PR,15,PL24,91584,91552,32,32,0
2021-11-27,RA,17,PL34,250344,245064,5376,5376,0
2021-09-21,HO,18,PL03,66936,66896,88,88,0
2021-04-08,HO,18,PL33,66224,66224,0,0,0
2021-06-18,SD,13,PL21,69147,68542,1351,720,631
2021-07-02,SD,13,PL22,63623,63578,1701,1536,165
2021-07-30,HO,18,PL32,0,0,0,0,0
2021-09-14,HO,18,PL11,66048,66048,0,0,0
2021-10-10,SD,13,PL25,72773,72289,1060,576,484
2021-01-29,EC,10,PL43,623472,622752,1632,1632,0
2021-08-17,SD,13,PL18,24930,24698,240,0,240
2021-02-06,CL,14,PL44,303328,298144,992,992,0
2021-09-15,HO,18,PL11,61800,61600,360,360,0
2021-11-17,PR,15,PL04,264128,263584,704,704,0
2021-03-18,HO,18,PL30,66024,65264,760,760,0
2021-07-20,CH,24,PL08,90795,89934,2796,1472,1324
2021-08-21,CA,23,PL31,126936,126456,600,600,0
2021-01-31,SD,13,PL18,69764,68933,1100,224,876
2021-11-02,HO,18,PL33,105136,103568,1920,1920,0
2021-04-16,CA,23,PL02,231336,230496,1320,1320,0
2021-11-17,NT,16,PL51,499104,499008,416,416,0
2021-05-22,RT,21,PL42,183280,180400,3152,3152,0
2021-08-30,HO,18,PL10,68464,68416,104,104,0
2021-10-27,SD,13,PL20,66465,66097,968,512,456
2021-04-30,RT,21,PL42,169120,142512,26880,26880,0
2021-06-05,CA,23,PL02,229392,228264,1440,1440,0
2021-02-17,CA,23,PL13,84808,84648,224,224,0
2021-06-30,CH,24,PL08,278160,258750,24103,4544,19559
2021-12-08,CA,23,PL35,0,0,200,200,0
2021-12-01,CA,23,PL02,202344,201408,2064,2064,0
2021-04-17,HO,18,PL11,28744,28656,328,328,0
2021-11-08,SD,13,PL18,70524,70176,1853,1456,397
2021-04-22,CA,23,PL31,201456,197808,3792,3792,0
2021-01-08,HO,18,PL09,64584,64416,320,320,0
2021-08-03,PB,25,PL54,365056,359520,6112,6112,0
2021-03-07,PR,15,PL24,262272,262240,416,416,0
2021-04-13,PB,25,PL54,267456,208672,58784,58784,0
2021-11-25,SD,13,PL21,65377,65100,742,400,342
2021-05-04,NT,16,PL51,468224,466208,2528,2528,0
2021-06-14,HO,18,PL01,68160,67592,568,568,0
2021-12-07,RT,21,PL05,200544,197952,2808,2808,0
2021-10-12,PB,25,PL54,437088,404960,32672,32672,0
2021-06-28,RA,17,PL34,221232,221208,312,312,0
2021-10-11,HO,18,PL01,67144,66856,288,288,0
2021-01-25,SD,13,PL21,66109,64398,2275,352,1923
2021-06-01,RT,21,PL42,168464,160448,8256,8256,0
2021-04-03,CA,23,PL02,149664,148176,1512,1512,0
2021-07-11,HO,18,PL40,66208,66064,144,144,0
2021-11-12,CH,24,PL57,32904,32856,56,56,0
2021-06-02,SD,13,PL25,66185,64149,3306,1232,2074
2021-12-07,SD,13,PL19,66147,65008,1331,192,1139
2021-01-06,DI,19,PL53,291872,292000,800,800,0
2021-04-11,CH,24,PL07,290187,284553,14669,8832,5837
2021-02-26,SB,11,PL36,313608,312432,1176,1176,0
2021-01-05,SD,13,PL19,75684,75526,574,416,158
2021-11-06,RA,17,PL35,263256,262512,1104,1104,0
2021-05-24,RT,21,PL05,0,0,0,0,0
2021-02-04,HO,18,PL30,66160,66160,0,0,0
2021-05-19,RT,21,PL05,152952,148536,4464,4464,0
2021-02-08,HO,18,PL10,57696,57696,0,0,0
2021-04-20,PR,15,PL24,264832,264192,1088,1088,0
2021-03-11,CL,14,PL44,218944,206464,15872,15872,0
2021-03-27,RA,17,PL35,10344,6048,4296,4296,0
2021-07-14,CL,14,PL44,248128,245728,3296,3296,0
2021-08-12,HO,18,PL03,66888,66632,160,160,0
2021-10-09,HO,18,PL33,131152,130944,208,208,0
2021-07-05,SD,13,PL25,74754,74287,717,176,541
2021-12-04,SD,13,PL18,63754,62879,1227,352,875
2021-03-10,HO,18,PL03,66120,66024,136,136,0
2021-02-10,DI,19,PL52,295552,295616,704,704,0
2021-09-16,CA,23,PL13,85824,85664,208,208,0
2021-11-30,HO,18,PL32,52672,52336,456,456,0
2021-09-02,CA,23,PL02,219936,219288,816,816,0
2021-10-13,PRG,12,PL14,390368,387392,3296,3296,0
2021-02-04,DI,19,PL53,298336,297568,1056,1056,0
2021-11-01,CH,24,PL07,167450,167376,3630,3008,622
2021-01-15,NT,16,PL51,419648,419008,6080,6080,0
2021-06-11,CL,14,PL45,21664,15904,5632,5632,0
2021-12-17,SD,13,PL21,76250,75629,811,176,635
2021-07-28,HO,18,PL11,0,0,352,352,0
2021-09-27,HO,18,PL30,0,0,2304,2304,0
2021-09-25,PR,15,PL04,263552,261888,2080,2080,0
2021-09-04,SD,13,PL25,75257,74493,1116,352,764
2021-12-23,RA,17,PL56,70776,70464,312,312,0
2021-05-12,SB,11,PL50,414112,413728,1056,1056,0
2021-05-31,PB,25,PL54,438720,430368,9152,9152,0
2021-07-11,RT,21,PL05,201792,198096,3720,3720,0
2021-04-29,CA,23,PL31,232536,232416,384,384,0
2021-02-25,HO,18,PL03,26552,26544,8,8,0
2021-07-15,SD,13,PL22,0,0,2210,2208,2
2021-01-31,CA,23,PL13,85424,85432,88,88,0
2021-02-01,HO,18,PL32,67064,64440,2624,2624,0
2021-10-14,HO,18,PL01,64920,60184,4736,4736,0
2021-11-04,SD,13,PL25,38226,38226,8951,7344,1607
2021-11-03,HO,18,PL33,121504,120720,784,784,0
2021-06-04,HO,18,PL40,53856,53536,392,392,0
2021-05-30,HO,18,PL09,72264,72176,88,88,0
2021-03-31,RT,21,PL42,185344,177904,7440,7440,0
2021-09-24,SD,13,PL22,76628,76597,45,0,45
2021-09-21,HO,18,PL40,66200,66064,136,136,0
2021-03-21,CL,14,PL45,303552,294816,2400,2400,0
2021-04-15,PB,25,PL55,449984,450624,2400,2400,0
2021-07-03,PW,26,PL37,816288,815280,2544,2544,0
2021-01-31,DI,19,PL53,293728,293056,1504,1504,0
2021-03-24,HO,18,PL30,63088,62800,288,288,0
2021-05-19,SD,13,PL17,72366,72041,1237,912,325
2021-12-19,HO,18,PL09,66192,65968,224,224,0
2021-07-13,SD,13,PL17,53925,52669,1960,704,1256
2021-08-22,HO,18,PL09,73160,73160,0,0,0
2021-10-12,HO,18,PL30,0,0,3008,3008,0
2021-12-19,SD,13,PL21,65161,64530,1117,384,733
2021-02-28,SD,13,PL22,31319,31210,956,736,220
2021-07-04,PRG,12,PL14,383008,383072,1152,1152,0
2021-04-09,PRG,12,PL14,388576,388608,1024,1024,0
2021-08-11,HO,18,PL09,72344,72272,120,120,0
2021-10-03,SD,13,PL25,69705,68463,1764,496,1268
2021-10-20,RT,21,PL06,192840,191424,1584,1584,0
2021-12-13,SB,11,PL36,305088,301896,3576,3576,0
2021-01-04,HO,18,PL32,59872,59872,272,272,0
2021-03-29,SD,13,PL19,11818,11818,544,544,0
2021-08-19,PR,15,PL24,231040,230368,1504,1504,0
2021-06-05,RT,21,PL42,18384,15456,3184,3184,0
2021-01-15,SD,13,PL21,67336,65828,2132,624,1508
2021-05-07,SD,13,PL19,67025,66935,1113,1008,105
2021-08-05,HO,18,PL56,66096,65632,464,464,0
2021-03-07,SD,13,PL17,73685,73510,408,176,232
2021-03-05,HO,18,PL32,67464,67392,96,96,0
2021-08-24,HO,18,PL11,66200,66280,0,0,0
2021-05-01,PR,15,PL57,138144,136496,1776,1776,0
2021-06-27,CH,24,PL07,268191,243326,30182,5312,24870
2021-08-13,RT,21,PL41,0,0,0,0,0
2021-02-06,CL,14,PL45,301312,292480,1248,1248,0
2021-03-12,RT,21,PL06,206376,205632,1008,1008,0
2021-08-27,PR,15,PL24,262432,255520,7552,7552,0
2021-06-13,SD,13,PL25,72563,71843,1424,704,720
2021-09-29,CL,14,PL44,300224,298976,800,800,0
2021-09-26,PB,25,PL55,360896,355104,6624,6624,0
2021-01-26,SD,13,PL21,48001,46809,1304,16,1288
2021-02-20,PW,26,PL37,810624,805824,5616,5616,0
2021-08-23,HO,18,PL03,67592,67592,0,0,0
2021-08-31,HO,18,PL11,65144,65008,136,136,0
2021-05-08,RA,17,PL34,220656,220344,360,360,0
2021-12-01,SD,13,PL25,41387,40893,1022,528,494
2021-03-04,PRG,12,PL14,0,0,15776,15776,0
2021-04-17,SD,13,PL18,59215,59153,449,384,65
2021-10-12,SD,13,PL21,65523,65305,672,400,272
2021-08-26,HO,18,PL11,66288,66288,0,0,0
2021-01-04,HO,18,PL03,67248,67160,88,88,0
2021-03-07,RT,21,PL05,207312,207264,336,336,0
2021-05-17,HO,18,PL03,66320,66192,128,128,0
2021-05-15,RA,17,PL56,209208,206736,2472,2472,0
2021-10-21,SD,13,PL20,76263,76085,354,176,178
2021-07-23,CH,24,PL07,143454,131252,16241,3776,12465
2021-11-24,SD,13,PL25,72913,72252,952,176,776
2021-05-31,SD,13,PL20,59933,59476,2042,1584,458
2021-11-08,CA,23,PL02,186432,186336,888,888,0
2021-03-27,PB,25,PL55,415456,412032,4128,4128,0
2021-08-29,HO,18,PL11,65096,65000,224,224,0
2021-01-31,SD,13,PL17,33,0,33,0,33
2021-06-15,RA,17,PL35,193536,190584,2952,2952,0
2021-11-25,DI,19,PL53,291488,288640,3168,3168,0
2021-03-11,HO,18,PL01,64208,63688,528,528,0
2021-04-21,SD,13,PL17,74151,73916,798,576,222
2021-09-12,EC,10,PL43,594432,592896,1200,1200,0
2021-11-19,HO,18,PL11,66168,66008,160,160,0
2021-11-29,HO,18,PL09,65288,64856,432,432,0
2021-04-25,PR,15,PL04,258048,257088,1248,1248,0
2021-05-03,HO,18,PL01,29376,28576,864,864,0
2021-08-08,HO,18,PL10,67248,67120,128,128,0
2021-10-07,EC,10,PL43,9648,4128,5088,5088,0
2021-04-19,HO,18,PL09,39360,37672,1688,1688,0
2021-08-30,SD,13,PL20,63944,63823,297,176,121
2021-11-15,HO,18,PL32,57096,56824,264,264,0
2021-06-09,CL,14,PL45,152544,123936,25152,25152,0
2021-04-24,RT,21,PL05,209736,210024,0,0,0
2021-06-11,PW,26,PL37,544560,542256,2784,2784,0
2021-12-05,RT,21,PL42,71360,62896,8464,8464,0
2021-01-10,CL,14,PL44,27456,26368,448,448,0
2021-04-27,PR,15,PL57,48528,48496,192,192,0
2021-06-26,DI,19,PL52,291424,290112,1824,1824,0
2021-07-31,HO,18,PL10,64216,63680,648,648,0
2021-09-15,HO,18,PL40,66160,66104,112,112,0
2021-03-07,SD,13,PL18,62974,60387,2765,176,2589
2021-11-10,SD,13,PL18,48804,47941,2067,1008,1059
2021-06-27,HO,18,PL03,66040,64616,1456,1456,0
2021-09-15,CH,24,PL12,164368,164128,240,240,0
2021-01-29,CL,14,PL44,302368,294560,928,928,0
2021-02-27,RA,17,PL34,35040,34728,456,456,0
2021-10-17,PR,15,PL04,267072,266656,640,640,0
2021-11-20,PB,25,PL54,442080,440192,5472,5472,0
2021-09-15,HO,18,PL03,66648,66560,144,144,0
2021-10-17,CH,24,PL08,239142,236572,13130,10560,2570
2021-10-30,SD,13,PL20,56614,55943,2080,1344,736
2021-10-05,NT,16,PL51,511712,510880,1312,1312,0
2021-01-31,HO,18,PL33,67728,67648,176,176,0
2021-02-21,HO,18,PL01,64320,63920,400,400,0
2021-06-23,RT,21,PL05,189216,188712,504,504,0
2021-08-16,SD,13,PL25,75775,75402,565,192,373
2021-03-04,RA,17,PL34,219288,219168,336,336,0
2021-03-03,SD,13,PL21,69393,68752,2817,2176,641
2021-01-07,HO,18,PL30,65216,65144,104,104,0
2021-05-11,SD,13,PL22,71611,71379,763,464,299
2021-05-25,SD,13,PL22,66516,65960,4569,3952,617
2021-11-05,HO,18,PL10,68720,68576,144,144,0
2021-03-16,CL,14,PL45,148576,126272,31424,31424,0
2021-06-14,CL,14,PL45,211904,203232,7712,7712,0
2021-02-13,RT,21,PL42,188672,185408,3264,3264,0
2021-05-19,PW,26,PL37,747600,742032,6864,6864,0
2021-10-22,DI,19,PL52,294848,295456,0,0,0
2021-11-15,CA,23,PL31,221376,215472,6024,6024,0
2021-11-18,DI,19,PL53,0,0,0,0,0
2021-07-29,RT,21,PL05,208728,208728,0,0,0
2021-01-16,HO,18,PL30,65672,65656,88,88,0
2021-08-05,SD,13,PL25,49545,49312,1033,800,233
2021-02-02,RT,21,PL42,44112,40704,3520,3520,0
2021-05-29,RA,17,PL56,219120,218088,1104,1104,0
2021-06-17,RT,21,PL06,168192,168048,984,984,0
2021-04-04,CH,24,PL07,59878,53672,21534,3616,17918
2021-04-30,RT,21,PL41,0,0,0,0,0
2021-02-27,NT,16,PL51,456288,454176,2112,2112,0
2021-02-24,HO,18,PL03,65280,64328,1024,1024,0
2021-04-09,RT,21,PL06,148824,147384,23928,23928,0
2021-11-29,HO,18,PL33,68880,67800,1120,1120,0
2021-02-05,DI,19,PL53,295840,295040,1216,1216,0
2021-02-14,SB,11,PL36,312744,311568,1128,1128,0
2021-01-30,PW,26,PL37,812640,807936,6240,6240,0
2021-05-08,EC,10,PL43,179088,179056,176,176,0
2021-06-29,SD,13,PL17,70798,69753,1653,608,1045
2021-09-07,PR,15,PL04,36736,2720,34016,34016,0
2021-02-28,RT,21,PL42,191600,189792,2096,2096,0
2021-07-29,PW,26,PL37,807648,807648,3792,3792,0
2021-03-17,DI,19,PL52,227648,227616,384,384,0
2021-05-26,PB,25,PL54,197568,163520,34048,34048,0
2021-02-27,SB,11,PL36,302064,300024,2040,2040,0
2021-01-30,HO,18,PL09,72264,72224,192,192,0
2021-07-20,HO,18,PL03,66592,66248,424,424,0
2021-09-26,SB,11,PL36,306408,304440,1992,1992,0
2021-09-09,PB,25,PL54,448704,447424,1696,1696,0
2021-04-08,RT,21,PL06,0,0,840,840,0
2021-10-12,PB,25,PL55,267552,197504,70464,70464,0
2021-10-27,EC,10,PL43,372720,367824,4032,4032,0
2021-04-29,PB,25,PL55,446656,446784,1344,1344,0
2021-11-25,RT,21,PL41,42320,32544,9776,9776,0
2021-02-13,EC,10,PL43,619248,618288,1632,1632,0
2021-05-21,PB,25,PL54,412960,400896,12640,12640,0
2021-03-19,CL,14,PL44,298816,292576,1344,1344,0
2021-10-08,CA,23,PL31,0,0,3720,3720,0
2021-11-09,HO,18,PL03,67056,67088,96,96,0
2021-04-16,PR,15,PL57,122880,120640,2240,2240,0
2021-07-01,SD,13,PL25,74604,74132,1176,704,472
2021-03-21,SD,13,PL20,70789,70535,694,352,342
2021-12-02,RA,17,PL34,179880,178920,960,960,0
2021-09-17,HO,18,PL11,66192,66216,0,0,0
2021-05-13,HO,18,PL30,28608,28472,808,808,0
2021-10-16,RT,21,PL41,177824,172416,5456,5456,0
2021-08-24,SD,13,PL17,38523,37926,13245,11504,1741
2021-09-12,PB,25,PL54,269280,261248,8736,8736,0
2021-11-01,HO,18,PL32,56824,56736,88,88,0
2021-01-09,DI,19,PL52,293056,292992,640,640,0
2021-04-15,HO,18,PL10,55376,55240,272,272,0
2021-11-08,PR,15,PL04,68832,66592,2720,2720,0
2021-02-08,PRG,12,PL14,396544,396608,256,256,0
2021-08-27,RT,21,PL05,184800,184608,2280,2280,0
2021-10-18,CL,14,PL44,300192,298464,1568,1568,0
2021-09-15,SD,13,PL21,5091,5069,25,0,25
2021-12-18,HO,18,PL01,67696,67456,288,288,0
2021-01-25,DI,19,PL52,291040,289152,1888,1888,0
2021-03-10,CL,14,PL44,80384,68768,18880,18880,0
2021-04-30,DI,19,PL53,291872,290400,1824,1824,0
2021-06-27,RT,21,PL06,208560,208296,264,264,0
2021-02-19,CH,24,PL04,163728,163232,560,560,0
2021-07-04,HO,18,PL03,66632,66544,88,88,0
2021-10-04,RT,21,PL05,208512,208512,0,0,0
2021-03-25,DI,19,PL52,299360,299616,0,0,0
2021-03-07,CH,24,PL07,306989,300100,9747,2848,6899
2021-10-27,PB,25,PL54,442560,435680,7840,7840,0
2021-11-04,PW,26,PL37,807792,808080,1776,1776,0
2021-05-03,SB,11,PL50,275488,272608,42560,42560,0
2021-08-09,CA,23,PL02,169896,168192,1704,1704,0
2021-02-10,DI,19,PL53,292384,288192,4320,4320,0
2021-11-23,CH,24,PL08,250112,242944,7520,7520,0
2021-03-03,DI,19,PL53,295584,295584,384,384,0
2021-04-07,HO,18,PL33,62352,62224,808,808,0
2021-05-20,RT,21,PL06,193008,190584,2496,2496,0
2021-05-14,CH,24,PL07,298543,289784,13426,4448,8978
2021-06-30,PRG,12,PL14,392128,391744,864,864,0
2021-11-12,SD,13,PL17,66354,66187,699,544,155
2021-07-10,HO,18,PL09,72368,72288,88,88,0
2021-05-28,HO,18,PL32,66288,66144,248,248,0
2021-09-18,RT,21,PL42,188544,184160,4624,4624,0
2021-10-05,SD,13,PL20,67937,67452,879,368,511
2021-07-08,CA,23,PL11,234744,233208,1752,1752,0
2021-09-20,EC,10,PL43,622944,622464,1200,1200,0
2021-10-20,CL,14,PL44,227936,225952,4384,4384,0
2021-03-22,DI,19,PL52,231456,231264,0,0,0
2021-04-26,SD,13,PL21,69617,69586,548,528,20
2021-01-19,DI,19,PL53,285536,284864,1408,1408,0
2021-02-20,CL,14,PL44,301152,281760,1824,1824,0
2021-05-09,HO,18,PL30,66040,65736,392,392,0
2021-08-31,CA,23,PL02,143472,142968,936,936,0
2021-03-07,HO,18,PL09,72800,72800,0,0,0
2021-05-15,CH,24,PL57,29220,29208,316,316,0
2021-09-10,CA,23,PL13,84464,84384,200,200,0
2021-09-15,SD,13,PL20,74110,74071,407,368,39
2021-02-03,HO,18,PL10,53624,52352,1392,1392,0
2021-02-22,NT,16,PL51,406336,404640,2912,2912,0
2021-02-02,CA,23,PL02,227232,222480,5040,5040,0
2021-02-24,SD,13,PL22,72772,72673,321,176,145
2021-05-16,CA,23,PL11,213744,213048,1032,1032,0
2021-10-26,PW,26,PL37,523824,520656,3552,3552,0
2021-01-16,DI,19,PL53,296736,296576,736,736,0
2021-07-15,RT,21,PL05,169152,168960,1944,1944,0
2021-09-02,HO,18,PL10,69128,69160,0,0,0
2021-02-20,CA,23,PL31,0,0,0,0,0
2021-07-11,PRG,12,PL14,389472,388704,1760,1760,0
2021-11-06,SD,13,PL18,73171,72824,1524,1088,436
2021-12-13,PW,26,PL37,810192,810192,3696,3696,0
2021-12-09,HO,18,PL01,67688,67192,520,520,0
2021-03-22,PW,26,PL37,807360,806352,1920,1920,0
2021-10-14,SD,13,PL20,74088,73573,1128,544,584
2021-05-29,NT,16,PL51,467904,466752,2112,2112,0
2021-06-03,DI,19,PL52,286560,285280,1632,1632,0
2021-09-16,DI,19,PL53,85664,83488,2304,2304,0
2021-12-05,SD,13,PL18,58322,57737,2089,1504,585
2021-05-09,PB,25,PL54,247552,166368,81184,81184,0
2021-09-26,HO,18,PL32,57656,57656,0,0,0
2021-10-07,HO,18,PL01,67512,67104,408,408,0
2021-05-12,RA,17,PL35,167712,164592,3120,3120,0
2021-09-15,RT,21,PL42,92560,51984,40576,40576,0
2021-04-28,SD,13,PL25,70358,70159,1063,864,199
2021-02-07,CA,23,PL02,237456,234360,3384,3384,0
2021-06-17,PR,15,PL12,138304,138240,256,256,0
2021-07-15,CH,24,PL08,68,62,6,0,6
2021-09-05,CH,24,PL07,309400,294714,23806,9120,14686
2021-03-05,PRG,12,PL14,171744,137856,34208,34208,0
2021-04-29,CA,23,PL11,199272,191400,9072,9072,0
2021-12-08,HO,18,PL33,71936,71704,384,384,0
2021-11-18,HO,18,PL30,0,0,928,928,0
2021-05-27,SD,13,PL19,71415,69934,2025,544,1481
2021-07-13,CL,14,PL44,301536,299104,1088,1088,0
2021-09-13,SD,13,PL21,65199,64862,1397,1056,341
2021-10-06,CH,24,PL07,279818,272612,13463,5568,7895
2021-01-06,PR,15,PL24,258976,255776,3200,3200,0
2021-06-23,RT,21,PL06,178752,174720,4296,4296,0
2021-08-21,HO,18,PL10,67824,67424,400,400,0
2021-09-13,HO,18,PL33,121872,120992,880,880,0
2021-11-17,CA,23,PL13,84768,84728,312,312,0
2021-03-01,SD,13,PL18,64631,63594,1374,176,1198
2021-02-07,SD,13,PL25,71628,71411,601,384,217
2021-09-09,SD,13,PL18,76825,76503,322,0,322
2021-12-16,RT,21,PL05,208848,208392,600,600,0
2021-04-03,HO,18,PL30,38488,38344,144,144,0
2021-09-22,HO,18,PL11,66264,66152,112,112,0
2021-03-28,CA,23,PL13,73552,73464,184,184,0
2021-06-29,CA,23,PL02,235320,235224,696,696,0
2021-07-14,HO,18,PL56,65736,64744,992,992,0
2021-11-11,SD,13,PL25,64545,62731,2200,400,1800
2021-10-01,HO,18,PL40,66248,66088,160,160,0
2021-12-22,PB,25,PL55,449536,449056,1120,1120,0
2021-06-01,CA,23,PL31,224904,224112,1200,1200,0
2021-10-18,PW,26,PL37,433824,432432,1968,1968,0
2021-03-02,RA,17,PL56,219552,219024,528,528,0
2021-12-13,HO,18,PL33,70560,70000,560,560,0
2021-06-25,CH,24,PL07,298371,287992,16942,5856,11086
2021-09-24,HO,18,PL56,65056,64536,520,520,0
2021-02-03,RT,21,PL06,175728,175248,624,624,0
2021-05-15,HO,18,PL33,61800,61800,0,0,0
2021-01-05,HO,18,PL32,58736,58632,104,104,0
2021-05-04,HO,18,PL33,53448,53048,392,392,0
2021-10-25,SD,13,PL25,76377,75741,812,176,636
2021-05-25,PB,25,PL55,388448,369664,19200,19200,0
2021-12-18,SD,13,PL22,71378,71315,890,800,90
2021-07-25,PW,26,PL37,814224,813024,2928,2928,0
2021-11-29,SD,13,PL21,63193,62762,842,400,442
2021-04-11,RT,21,PL05,205032,205200,288,288,0
2021-02-20,SD,13,PL21,73422,72768,894,240,654
2021-06-12,NT,16,PL51,463616,460000,3712,3712,0
2021-07-04,RT,21,PL42,184640,182848,3552,3552,0
2021-10-22,DI,19,PL53,279840,280256,1024,1024,0
2021-09-02,RA,17,PL34,148704,146208,3648,3648,0
2021-08-09,SD,13,PL22,12447,12387,60,0,60
2021-01-15,SD,13,PL19,62155,61630,1060,480,580
2021-05-10,PB,25,PL54,231072,188288,44544,44544,0
2021-04-30,SD,13,PL25,73624,73491,341,208,133
2021-09-02,HO,18,PL40,66288,66256,32,32,0
2021-01-24,SD,13,PL18,71124,70990,509,352,157
2021-04-12,PW,26,PL37,802560,804240,2112,2112,0
2021-04-23,SB,11,PL36,0,0,888,888,0
2021-12-05,HO,18,PL09,66264,66264,0,0,0
2021-02-26,RT,21,PL41,19024,11408,7616,7616,0
2021-07-09,HO,18,PL33,61752,61664,88,88,0
2021-02-09,CA,23,PL02,220512,212520,8352,8352,0
2021-08-01,EC,10,PL43,622512,619632,2976,2976,0
2021-02-12,RA,17,PL34,217752,217728,960,960,0
2021-06-16,CA,23,PL02,233880,233688,624,624,0
2021-06-12,SB,11,PL50,454400,453504,1472,1472,0
2021-10-29,SD,13,PL25,19805,19715,141,0,141
2021-06-17,CH,24,PL57,33212,33192,216,216,0
2021-11-15,PR,15,PL04,263200,262560,640,640,0
2021-01-29,PR,15,PL57,141904,141904,368,368,0
2021-09-23,SD,13,PL17,74708,74572,941,752,189
2021-01-27,CA,23,PL02,188784,188208,1248,1248,0
2021-11-03,EC,10,PL43,557904,552240,5712,5712,0
2021-01-07,RA,17,PL56,208200,207552,984,984,0
2021-03-20,HO,18,PL33,59816,59432,384,384,0
2021-01-23,SB,11,PL50,452992,451488,2528,2528,0
2021-02-10,SD,13,PL21,72129,71096,1615,560,1055
2021-02-27,CH,24,PL07,271193,257784,23551,8768,14783
2021-05-24,CA,23,PL11,123072,117696,5640,5640,0
2021-07-09,PR,15,PL12,54336,54304,1760,1760,0
2021-04-23,CA,23,PL02,135360,133200,2664,2664,0
2021-11-21,SD,13,PL21,64505,64109,589,192,397
2021-05-12,HO,18,PL30,61624,61384,240,240,0
2021-12-15,PRG,12,PL14,395904,394432,1696,1696,0
2021-01-22,DI,19,PL52,299296,299648,0,0,0
2021-09-17,HO,18,PL10,68064,68080,152,152,0
2021-03-21,CH,24,PL12,160896,159904,1088,1088,0
2021-05-26,DI,19,PL53,293888,293632,992,992,0
2021-02-21,HO,18,PL32,65912,64560,1352,1352,0
2021-03-10,SD,13,PL25,62439,62412,402,368,34
2021-11-02,HO,18,PL01,67648,66920,728,728,0
2021-05-25,HO,18,PL03,66744,66656,112,112,0
2021-05-31,SD,13,PL18,55663,55221,1002,560,442
2021-09-01,PR,15,PL04,285312,278304,7360,7360,0
2021-12-12,CA,23,PL13,85008,84864,176,176,0
2021-05-02,HO,18,PL03,65264,65224,104,104,0
2021-12-22,CA,23,PL31,212352,209736,2616,2616,0
2021-02-07,CH,24,PL07,87956,86574,4390,3008,1382
2021-04-23,PRG,12,PL14,392032,391840,960,960,0
2021-06-05,SB,11,PL36,303840,301824,2136,2136,0
2021-09-10,RA,17,PL35,214392,213288,1656,1656,0
2021-07-11,SD,13,PL18,73403,73249,2602,2448,154
2021-10-15,DI,19,PL53,269216,267712,2848,2848,0
2021-10-06,HO,18,PL01,66864,66440,424,424,0
2021-01-22,SD,13,PL22,65033,64541,2252,1760,492
2021-05-17,CH,24,PL08,257564,244021,20943,6464,14479
2021-11-26,HO,18,PL30,23136,19952,3184,3184,0
2021-12-20,HO,18,PL30,1296,0,1296,1296,0
2021-03-30,HO,18,PL03,66232,66232,0,0,0
2021-03-24,PW,26,PL37,815136,813744,2832,2832,0
2021-05-06,SD,13,PL20,73498,73267,797,592,205
2021-12-01,DI,19,PL52,290336,288800,1760,1760,0
2021-09-18,CH,24,PL57,34156,34212,48,48,0
2021-06-28,SD,13,PL17,66193,65379,1950,1136,814
2021-10-24,RA,17,PL34,259872,259392,720,720,0
2021-03-13,CA,23,PL31,210720,207456,3504,3504,0
2021-06-23,NT,16,PL51,486752,484640,2464,2464,0
2021-02-01,CA,23,PL02,236280,232800,3576,3576,0
2021-04-17,RT,21,PL06,166608,164712,2112,2112,0
2021-11-03,RT,21,PL06,166416,163512,3096,3096,0
2021-10-28,HO,18,PL11,66120,66208,0,0,0
2021-11-19,CH,24,PL57,1128,1128,0,0,0
2021-04-08,SD,13,PL20,74246,73022,1592,368,1224
2021-06-22,CL,14,PL44,295008,291584,3232,3232,0
2021-09-25,CH,24,PL57,34060,34048,52,52,0
2021-12-02,CH,24,PL07,2216,0,12552,10336,2216
2021-08-09,CL,14,PL45,301696,299392,864,864,0
2021-03-30,CH,24,PL08,285382,276586,12188,3392,8796
2021-10-16,CA,23,PL13,82752,82656,192,192,0
2021-01-12,RA,17,PL56,196920,194256,3072,3072,0
2021-06-16,PR,15,PL24,265792,265664,512,512,0
2021-05-26,HO,18,PL09,71952,71960,96,96,0
2021-01-07,SD,13,PL19,53031,52601,2106,1664,442
2021-02-25,RA,17,PL35,204984,200760,4368,4368,0
2021-03-21,HO,18,PL01,66184,65984,200,200,0
2021-04-29,HO,18,PL33,66224,66216,8,8,0
2021-07-20,SD,13,PL17,59938,56511,5123,1696,3427
2021-07-21,PB,25,PL54,429536,425632,4544,4544,0
2021-05-03,SB,11,PL36,215160,205656,9864,9864,0
2021-04-04,HO,18,PL30,66224,66224,0,0,0
2021-06-17,HO,18,PL40,63512,63416,96,96,0
2021-02-11,PR,15,PL24,265568,264992,768,768,0
2021-01-31,CL,14,PL45,291392,279424,5376,5376,0
2021-09-15,PR,15,PL24,266080,264352,2336,2336,0
2021-06-27,CH,24,PL08,255790,251856,8534,4512,4022
2021-07-27,SD,13,PL22,72155,72155,368,368,0
2021-03-31,HO,18,PL10,38848,38576,272,272,0
2021-11-24,CH,24,PL24,159856,159632,752,752,0
2021-01-05,PB,25,PL55,302528,234848,67680,67680,0
2021-01-12,PR,15,PL24,265600,264896,864,864,0
2021-04-16,CA,23,PL31,47472,44640,2832,2832,0
2021-06-07,PRG,12,PL14,391712,391136,928,928,0
2021-09-27,CH,24,PL57,34128,34092,56,56,0
2021-04-27,SB,11,PL36,283176,281640,1560,1560,0
2021-07-03,CA,23,PL02,222912,221952,1272,1272,0
2021-07-16,EC,10,PL43,635424,634800,816,816,0
2021-05-07,CA,23,PL11,227256,226200,1656,1656,0
2021-07-05,SD,13,PL18,0,0,1486,1472,14
2021-11-14,NT,16,PL51,510208,510432,1024,1024,0
2021-05-12,RA,17,PL34,189912,189792,264,264,0
2021-12-12,PW,26,PL37,794976,793824,4272,4272,0
2021-09-19,SD,13,PL25,75231,74317,1385,400,985
2021-01-08,RT,21,PL05,207096,206808,288,288,0
2021-09-28,CA,23,PL02,231120,231192,408,408,0
2021-09-21,RT,21,PL05,176304,175536,912,912,0
2021-09-23,SD,13,PL25,64457,63475,2504,1520,984
2021-02-07,HO,18,PL32,67784,67696,96,96,0
2021-10-30,NT,16,PL51,424416,423808,4992,4992,0
2021-04-12,HO,18,PL30,53120,52392,760,760,0
2021-12-16,SB,11,PL36,310896,309864,1152,1152,0
2021-02-16,HO,18,PL03,65984,65888,168,168,0
2021-10-26,CH,24,PL24,38192,38064,720,720,0
2021-04-13,PW,26,PL37,811392,810960,4272,4272,0
2021-05-31,SB,11,PL36,313128,311208,1920,1920,0
2021-08-07,CH,24,PL07,103021,90446,14687,2112,12575
2021-03-13,SD,13,PL20,74448,74142,720,400,320
2021-05-06,SD,13,PL19,23702,23478,1191,928,263
2021-04-15,RT,21,PL42,30160,27904,2720,2720,0
2021-05-21,RA,17,PL35,192672,186672,6216,6216,0
2021-07-03,NT,16,PL51,510688,508448,2400,2400,0
2021-08-04,CL,14,PL45,3872,3936,11104,11104,0
2021-01-26,NT,16,PL51,268928,264160,4768,4768,0
2021-12-08,NT,16,PL51,5888,5472,17632,17632,0
2021-02-11,RA,17,PL34,222936,223152,0,0,0
2021-07-09,HO,18,PL30,66208,66224,0,0,0
2021-03-15,HO,18,PL32,47720,47720,0,0,0
2021-11-09,EC,10,PL43,631440,629328,1872,1872,0
2021-01-03,RT,21,PL42,141040,137664,3664,3664,0
2021-09-23,HO,18,PL30,0,0,368,368,0
2021-09-25,SD,13,PL20,71300,71301,443,368,75
2021-11-09,SD,13,PL19,63441,62503,1740,800,940
2021-08-02,CA,23,PL31,184584,183528,1800,1800,0
2021-12-01,SB,11,PL50,8640,0,8640,8640,0
2021-03-23,PW,26,PL37,814416,814272,1488,1488,0
2021-05-07,CH,24,PL08,258120,249242,22312,13088,9224
2021-02-13,SD,13,PL18,73812,72945,1251,384,867
2021-05-20,PR,15,PL04,266848,267104,32,32,0
2021-01-06,NT,16,PL51,468288,468160,768,768,0
2021-05-28,CL,14,PL45,298816,295840,2272,2272,0
2021-02-12,PW,26,PL37,781776,780240,2928,2928,0
2021-05-22,PB,25,PL55,287488,236256,51520,51520,0
2021-01-29,SD,13,PL25,45452,45197,996,592,404
2021-09-29,CH,24,PL07,122060,121379,4583,3904,679
2021-02-19,PW,26,PL37,770400,764064,7440,7440,0
2021-03-29,CH,24,PL07,295367,283362,22117,10112,12005
2021-04-29,SD,13,PL20,73939,73819,903,704,199
2021-02-08,HO,18,PL30,63848,63608,240,240,0
2021-12-11,RT,21,PL06,208344,208368,264,264,0
2021-04-04,CA,23,PL31,50328,47496,3000,3000,0
2021-07-12,SD,13,PL20,75497,75478,237,176,61
2021-12-07,DI,19,PL52,292896,292640,448,448,0
2021-05-28,HO,18,PL10,57584,57400,184,184,0
2021-03-01,HO,18,PL11,63712,63648,320,320,0
2021-05-11,HO,18,PL01,54984,54184,800,800,0
2021-10-07,HO,18,PL09,67608,67272,336,336,0
2021-02-07,RA,17,PL35,200376,200184,312,312,0
2021-11-05,HO,18,PL56,66112,65848,272,272,0
2021-08-07,PB,25,PL55,0,0,4608,4608,0
2021-09-24,PR,15,PL04,266848,264608,2624,2624,0
2021-11-27,DI,19,PL52,295264,294944,448,448,0
2021-03-18,HO,18,PL03,62632,62592,608,608,0
2021-10-18,DI,19,PL53,294944,294912,768,768,0
2021-11-14,CA,23,PL13,85456,85432,96,96,0
2021-04-17,RA,17,PL35,181056,180216,840,840,0
2021-12-13,CA,23,PL02,179496,178248,1248,1248,0
2021-05-22,CL,14,PL45,160544,136000,24000,24000,0
2021-11-13,PB,25,PL54,442208,437248,6784,6784,0
2021-11-14,SD,13,PL20,66969,66843,126,0,126
2021-07-07,RT,21,PL42,191184,189504,1904,1904,0
2021-10-09,HO,18,PL56,65112,64800,312,312,0
2021-11-01,EC,10,PL43,567504,560208,4512,4512,0
2021-10-21,SD,13,PL18,60802,60403,796,384,412
2021-05-04,PRG,12,PL14,390816,391136,928,928,0
2021-07-23,HO,18,PL32,67448,67368,160,160,0
2021-02-23,RA,17,PL34,189360,189048,1368,1368,0
2021-05-20,HO,18,PL30,65368,65272,96,96,0
2021-02-05,CA,23,PL13,85168,85144,120,120,0
2021-10-21,SB,11,PL36,241632,231576,10248,10248,0
2021-04-29,HO,18,PL40,67280,67040,288,288,0
2021-10-27,HO,18,PL40,55064,54728,336,336,0
2021-07-08,EC,10,PL43,631296,629232,1824,1824,0
2021-09-22,CL,14,PL44,251584,222784,8704,8704,0
2021-08-24,SD,13,PL25,31666,30646,1772,544,1228
2021-09-30,SD,13,PL20,61463,60934,1133,544,589
2021-12-05,SB,11,PL50,450528,447616,3744,3744,0
2021-06-07,HO,18,PL30,63552,63456,528,528,0
2021-07-26,HO,18,PL30,65480,65328,160,160,0
2021-01-08,SD,13,PL19,73591,72592,1671,672,999
2021-11-03,CL,14,PL44,216640,211328,6976,6976,0
2021-02-23,RA,17,PL56,218352,218064,600,600,0
2021-06-01,HO,18,PL32,66544,66384,216,216,0
2021-05-13,CA,23,PL02,232032,231288,1056,1056,0
2021-08-21,HO,18,PL11,0,0,0,0,0
2021-03-23,CH,24,PL08,279105,268972,17311,6880,10431
2021-10-18,PB,25,PL54,434144,425408,14112,14112,0
2021-10-22,SD,13,PL25,74464,73502,1823,816,1007
2021-09-18,CL,14,PL44,297888,293984,3104,3104,0
2021-10-25,NT,16,PL51,511136,511328,352,352,0
2021-12-21,SB,11,PL36,308664,304584,4560,4560,0
2021-02-17,CL,14,PL45,247968,229056,5664,5664,0
2021-05-19,CA,23,PL11,235752,234912,1128,1128,0
2021-09-25,HO,18,PL33,132512,132512,0,0,0
2021-12-02,HO,18,PL30,139984,134224,5760,5760,0
2021-01-24,SD,13,PL19,61441,60871,762,192,570
2021-08-31,SD,13,PL20,51157,51114,444,400,44
2021-02-13,SD,13,PL22,72961,72882,552,384,168
2021-06-24,EC,10,PL43,532704,529728,4032,4032,0
2021-01-18,SD,13,PL21,71871,70432,1706,192,1514
2021-05-16,HO,18,PL10,47488,46952,624,624,0
2021-12-04,PB,25,PL55,376320,372448,5152,5152,0
2021-08-26,SD,13,PL25,74740,73876,1264,400,864
2021-04-12,CA,23,PL13,85400,85368,96,96,0
2021-03-23,SD,13,PL17,74107,73900,394,176,218
2021-01-11,HO,18,PL11,60664,59824,840,840,0
2021-02-20,PRG,12,PL14,394400,393504,896,896,0
2021-06-08,CA,23,PL02,177528,173640,4272,4272,0
2021-01-15,SD,13,PL22,70596,70148,848,400,448
2021-09-01,DI,19,PL53,192768,191616,2528,2528,0
2021-11-03,CH,24,PL24,163696,163824,176,176,0
2021-02-04,RT,21,PL42,164752,154832,9920,9920,0
2021-08-22,SD,13,PL20,75874,75800,280,192,88
2021-02-17,RT,21,PL05,185640,177048,8928,8928,0
2021-06-07,RT,21,PL05,207984,205872,2256,2256,0
2021-10-04,PRG,12,PL14,391776,391104,1824,1824,0
2021-10-30,SD,13,PL19,58588,58067,2384,1856,528
2021-01-12,SD,13,PL19,32681,30049,8120,5488,2632
2021-08-19,CA,23,PL02,0,0,1632,1632,0
2021-09-30,HO,18,PL32,56768,56616,232,232,0
2021-05-21,SD,13,PL17,70404,69531,1769,896,873
2021-10-13,HO,18,PL11,66288,66288,0,0,0
2021-05-05,HO,18,PL03,62696,62600,792,792,0
2021-07-23,HO,18,PL01,66616,65168,1448,1448,0
2021-12-22,PR,15,PL04,267488,267136,352,352,0
2021-08-13,EC,10,PL43,625728,622992,2400,2400,0
2021-08-17,SB,11,PL36,104832,104136,696,696,0
2021-11-23,CH,24,PL57,22868,22832,88,88,0
2021-06-08,SD,13,PL18,75360,75360,368,368,0
2021-12-07,PR,15,PL24,263392,263264,384,384,0
2021-12-16,HO,18,PL10,60536,60512,280,280,0
2021-05-10,HO,18,PL01,66200,65912,288,288,0
2021-07-10,HO,18,PL10,68296,68192,176,176,0
2021-06-30,CL,14,PL44,213600,210912,5440,5440,0
2021-12-05,CH,24,PL12,151936,151488,448,448,0
2021-02-27,RT,21,PL42,191824,190144,1808,1808,0
2021-03-21,RT,21,PL06,205056,203208,1848,1848,0
2021-05-29,HO,18,PL32,65824,65688,184,184,0
2021-06-21,HO,18,PL01,43776,42576,1288,1288,0
2021-06-17,HO,18,PL01,40152,39856,296,296,0
2021-03-26,DI,19,PL53,70656,69024,2400,2400,0
2021-07-21,CL,14,PL44,294912,291936,2432,2432,0
2021-11-10,SB,11,PL50,458240,456736,1952,1952,0
2021-05-04,CA,23,PL13,84968,84848,208,208,0
2021-07-05,RT,21,PL42,192688,191664,1088,1088,0
2021-09-20,CA,23,PL31,187848,185352,2496,2496,0
2021-06-21,PR,15,PL24,268256,268192,0,0,0
2021-02-01,SD,13,PL18,68669,67798,1248,368,880
2021-06-17,CH,24,PL08,41258,39336,5730,3808,1922
2021-08-24,HO,18,PL10,45504,44904,600,600,0
2021-10-25,HO,18,PL40,65920,65920,0,0,0
2021-09-14,DI,19,PL53,269728,269056,1216,1216,0
2021-10-10,RT,21,PL05,209520,209304,432,432,0
2021-06-27,HO,18,PL10,57024,56936,88,88,0
2021-10-29,CL,14,PL44,60800,59904,960,960,0
2021-12-17,SD,13,PL17,33561,33387,494,320,174
2021-04-29,SB,11,PL36,213264,212016,3720,3720,0
2021-01-21,CA,23,PL02,237864,236640,1440,1440,0
2021-01-12,PRG,12,PL12,378080,376064,3296,3296,0
2021-07-20,PRG,12,PL14,184416,171168,13248,13248,0
2021-08-01,PR,15,PL12,58704,56304,2400,2400,0
2021-09-01,HO,18,PL01,68056,67008,1048,1048,0
2021-01-07,SD,13,PL21,73076,71341,2136,384,1752
2021-12-11,SB,11,PL50,364288,344672,19616,19616,0
2021-07-18,PB,25,PL54,447040,447360,1056,1056,0
2021-05-03,PRG,12,PL14,388288,387808,1024,1024,0
2021-02-23,DI,19,PL53,295968,295968,384,384,0
2021-05-27,CH,24,PL07,163310,160938,6971,4160,2811
2021-10-07,CH,24,PL57,15920,15880,216,216,0
2021-07-28,HO,18,PL33,64760,64464,296,296,0
2021-01-18,SD,13,PL19,49879,49530,909,560,349
2021-09-25,SB,11,PL36,306960,305880,1176,1176,0
2021-10-06,RT,21,PL41,43024,0,43024,43024,0
2021-01-28,RT,21,PL06,206688,206544,408,408,0
2021-01-04,SD,13,PL22,39073,38986,87,0,87
2021-05-28,CA,23,PL31,226128,225192,1128,1128,0
2021-06-13,CA,23,PL31,228456,222528,6096,6096,0
2021-08-10,HO,18,PL01,48816,48384,432,432,0
2021-04-28,RT,21,PL05,204840,203184,2352,2352,0
2021-07-30,HO,18,PL10,68088,67680,496,496,0
2021-05-29,HO,18,PL01,67400,67376,88,88,0
2021-06-28,SD,13,PL21,67644,67189,855,400,455
2021-10-29,DI,19,PL53,7456,7232,416,416,0
2021-08-26,SD,13,PL19,73273,73229,803,736,67
2021-10-13,HO,18,PL32,0,0,344,344,0
2021-03-12,PRG,12,PL14,60928,49824,11104,11104,0
2021-04-14,CA,23,PL13,85488,85560,96,96,0
2021-07-12,HO,18,PL33,65112,64880,264,264,0
2021-09-26,HO,18,PL03,67016,66816,200,200,0
2021-11-04,HO,18,PL40,63808,63768,128,128,0
2021-09-30,CH,24,PL57,34140,34084,92,92,0
2021-05-27,CA,23,PL02,208056,204096,4200,4200,0
2021-08-17,PB,25,PL54,132096,131328,1344,1344,0
2021-09-15,CH,24,PL07,287225,272550,26323,11648,14675
2021-09-01,HO,18,PL56,49248,49184,568,568,0
2021-07-16,PB,25,PL54,400512,380928,20128,20128,0
2021-06-26,SD,13,PL21,70697,70232,1441,976,465
2021-03-08,CL,14,PL44,299360,295968,1216,1216,0
2021-03-15,PW,26,PL37,673728,673248,15840,15840,0
2021-07-26,PRG,12,PL14,392384,391456,1088,1088,0
2021-07-04,SD,13,PL21,74014,73745,701,432,269
2021-09-23,PR,15,PL24,265760,265504,512,512,0
2021-07-13,HO,18,PL30,66224,66224,0,0,0
2021-10-19,HO,18,PL40,54528,53064,1464,1464,0
2021-01-15,SD,13,PL20,69444,69207,2079,1840,239
2021-11-06,HO,18,PL40,66296,66296,0,0,0
2021-11-24,RA,17,PL34,258696,253944,4872,4872,0
2021-03-18,SD,13,PL17,71614,71517,627,448,179
2021-07-30,PB,25,PL54,433504,427872,6976,6976,0
2021-12-02,RT,21,PL05,209880,209568,312,312,0
2021-06-08,RT,21,PL42,76560,0,76560,76560,0
2021-06-20,CA,23,PL02,218592,206256,12912,12912,0
2021-03-02,HO,18,PL33,42736,41968,768,768,0
2021-05-26,PR,15,PL04,162400,156288,6400,6400,0
2021-10-30,CA,23,PL13,53112,53064,216,216,0
2021-11-03,HO,18,PL40,65256,63608,1648,1648,0
2021-12-08,CA,23,PL13,85416,85376,96,96,0
2021-04-09,SD,13,PL20,73525,72764,1735,960,775
2021-12-16,PB,25,PL55,285824,249184,36928,36928,0
2021-04-12,PRG,12,PL14,392096,391744,1056,1056,0
2021-10-08,RT,21,PL06,60264,60048,216,216,0
2021-08-26,PRG,12,PL14,392096,392096,896,896,0
2021-06-22,CA,23,PL31,201624,200232,1776,1776,0
2021-06-17,RT,21,PL42,0,0,31536,31536,0
2021-05-30,PR,15,PL04,264608,264480,416,416,0
2021-04-14,SD,13,PL17,73247,72983,636,368,268
2021-11-27,SB,11,PL50,212096,212544,800,800,0
2021-07-21,SD,13,PL20,75562,75518,444,400,44
2021-11-07,EC,10,PL43,616032,614688,3072,3072,0
2021-04-21,PR,15,PL04,261056,260096,1248,1248,0
2021-09-12,PRG,12,PL14,388192,384352,4160,4160,0
2021-11-21,CA,23,PL02,214584,214176,624,624,0
2021-10-17,CH,24,PL57,34116,34072,44,44,0
2021-01-05,NT,16,PL51,387712,387072,3808,3808,0
2021-04-27,HO,18,PL09,71984,70656,1336,1336,0
2021-07-24,HO,18,PL40,14968,14712,1608,1608,0
2021-08-06,CL,14,PL44,281856,272320,3552,3552,0
2021-07-17,PR,15,PL12,138144,137904,416,416,0
2021-05-11,PRG,12,PL14,369504,366240,3744,3744,0
2021-05-06,RA,17,PL35,213912,211416,2184,2184,0
2021-04-12,SD,13,PL22,75589,75515,906,832,74
2021-02-11,HO,18,PL01,43352,41840,1512,1512,0
2021-03-20,PR,15,PL04,226112,219392,6976,6976,0
2021-08-28,HO,18,PL01,63856,62576,1352,1352,0
2021-10-28,SB,11,PL36,158208,148704,9504,9504,0
2021-01-14,CA,23,PL31,199248,189696,9552,9552,0
2021-06-29,CL,14,PL44,296864,294656,1920,1920,0
2021-04-06,CH,24,PL07,292654,286103,13303,6752,6551
2021-09-14,SB,11,PL50,426976,421696,5888,5888,0
2021-01-02,SD,13,PL17,43757,43643,114,0,114
2021-07-28,SD,13,PL18,63838,63567,2537,2176,361
2021-03-30,PB,25,PL54,325920,299360,27488,27488,0
2021-09-20,HO,18,PL30,0,0,0,0,0
2021-05-20,SD,13,PL18,69953,69443,1310,736,574
2021-10-25,HO,18,PL32,53456,53232,256,256,0
2021-01-02,EC,10,PL43,119376,117248,1632,1632,0
2021-09-15,PR,15,PL04,280064,280000,640,640,0
2021-05-20,HO,18,PL33,66176,66072,104,104,0
2021-10-26,HO,18,PL56,66136,66232,0,0,0
2021-12-08,SD,13,PL22,76545,76337,256,32,224
2021-03-01,HO,18,PL10,55688,55520,272,272,0
2021-03-17,NT,16,PL51,463200,462464,1376,1376,0
2021-05-29,CA,23,PL02,234264,233664,1104,1104,0
2021-08-05,RA,17,PL34,93216,92352,5016,5016,0
2021-02-27,PRG,12,PL14,266048,248800,18016,18016,0
2021-08-08,CH,24,PL08,135217,132167,5034,1984,3050
2021-02-09,EC,10,PL43,578832,577056,1872,1872,0
2021-08-20,PRG,12,PL14,40128,39168,7872,7872,0
2021-09-30,CA,23,PL31,159792,155328,4680,4680,0
2021-01-29,HO,18,PL09,72136,72208,104,104,0
2021-06-29,SB,11,PL36,281520,278952,8160,8160,0
2021-08-05,HO,18,PL09,24688,24496,816,816,0
2021-07-26,RT,21,PL42,179984,176640,3552,3552,0
2021-09-04,RT,21,PL05,178416,178488,672,672,0
2021-01-25,CA,23,PL13,84648,84472,264,264,0
2021-08-24,PRG,12,PL14,382688,381152,3808,3808,0
2021-10-03,SB,11,PL36,266136,259944,6552,6552,0
2021-01-04,HO,18,PL33,63032,61496,1704,1704,0
2021-08-07,SD,13,PL25,74761,73558,1603,400,1203
2021-05-29,CH,24,PL07,217844,197327,31862,10848,21014
2021-08-16,CA,23,PL31,193152,192240,1176,1176,0
2021-05-21,HO,18,PL32,66816,66712,104,104,0
2021-10-29,HO,18,PL32,12384,12376,0,0,0
2021-01-17,PB,25,PL55,428000,403328,25408,25408,0
2021-07-22,HO,18,PL03,67424,67272,152,152,0
2021-10-16,CL,14,PL44,299072,285696,2880,2880,0
2021-10-24,DI,19,PL53,264128,263776,352,352,0
2021-10-06,PW,26,PL37,813168,813024,1440,1440,0
2021-12-05,SD,13,PL19,59453,58535,1478,560,918
2021-03-08,SD,13,PL18,71016,70561,1352,896,456
2021-12-07,HO,18,PL01,67544,66600,944,944,0
2021-03-26,HO,18,PL09,29024,26776,2248,2248,0
2021-07-04,CL,14,PL44,298560,296000,1856,1856,0
2021-10-02,CA,23,PL31,119784,118608,1488,1488,0
2021-07-21,EC,10,PL43,617184,609504,7680,7680,0
2021-10-07,RA,17,PL34,256728,254856,1872,1872,0
2021-07-05,CH,24,PL08,292238,286175,9519,3456,6063
2021-04-26,HO,18,PL01,66248,66216,32,32,0
2021-06-10,RT,21,PL42,49280,46464,2816,2816,0
2021-11-11,RA,17,PL35,256896,255408,1848,1848,0
2021-05-19,DI,19,PL52,281760,281248,1088,1088,0
2021-01-09,HO,18,PL11,66288,66288,0,0,0
2021-11-29,CH,24,PL12,164912,164736,192,192,0
2021-10-07,RT,21,PL06,128280,126744,2040,2040,0
2021-03-05,HO,18,PL10,53344,52720,728,728,0
2021-08-12,SD,13,PL19,69024,68795,4645,4416,229
2021-10-27,HO,18,PL56,42872,40256,2616,2616,0
2021-04-11,PRG,12,PL14,390432,390688,1152,1152,0
2021-08-28,CH,24,PL07,300184,290049,24663,14528,10135
2021-10-25,CH,24,PL07,81329,77354,8807,4832,3975
2021-11-26,EC,10,PL43,439968,436704,3936,3936,0
2021-01-19,SD,13,PL19,37724,37209,5779,5264,515
2021-10-19,SD,13,PL22,1963,1963,16,16,0
2021-09-17,RT,21,PL05,205464,205512,432,432,0
2021-07-21,CA,23,PL11,0,0,1464,1464,0
2021-02-21,SD,13,PL21,73456,72835,896,176,720
2021-04-24,CA,23,PL31,227496,226488,1272,1272,0
2021-04-07,SD,13,PL19,26478,26355,395,272,123
2021-10-27,PR,15,PL04,135488,133376,8864,8864,0
2021-09-08,CH,24,PL08,197857,181564,19141,2848,16293
2021-02-23,PR,15,PL24,181376,154592,27040,27040,0
2021-09-28,SD,13,PL20,75819,75773,242,192,50
2021-01-28,CH,24,PL07,33787,29546,6961,2720,4241
2021-10-05,DI,19,PL53,298272,298400,96,96,0
2021-03-29,HO,18,PL32,66736,66736,720,720,0
2021-10-24,CA,23,PL02,232632,232032,792,792,0
2021-04-21,HO,18,PL03,49888,49392,496,496,0
2021-11-27,CH,24,PL24,163648,163792,192,192,0
2021-05-15,EC,10,PL43,145888,145728,176,176,0
2021-05-19,RA,17,PL56,219528,218784,864,864,0
2021-09-23,SB,11,PL36,0,0,528,528,0
2021-10-07,SD,13,PL19,75866,75453,797,368,429
2021-11-05,HO,18,PL32,50472,49960,512,512,0
2021-02-13,HO,18,PL33,68456,67744,712,712,0
2021-05-31,SD,13,PL25,73175,72601,574,0,574
2021-03-20,NT,16,PL51,418272,413344,5184,5184,0
2021-10-07,HO,18,PL11,46776,46344,432,432,0
2021-04-06,RT,21,PL42,145632,136640,9120,9120,0
2021-03-10,RA,17,PL34,178896,178296,1656,1656,0
2021-10-05,PRG,12,PL14,389344,388064,2624,2624,0
2021-05-09,HO,18,PL32,67416,67352,112,112,0
2021-08-02,RT,21,PL42,173488,159232,14512,14512,0
2021-02-07,RA,17,PL56,198696,195432,3552,3552,0
2021-06-24,PR,15,PL24,265888,265888,352,352,0
2021-04-13,CH,24,PL07,270618,255925,28965,14272,14693
2021-06-04,RT,21,PL42,191968,184736,7232,7232,0
2021-12-12,SD,13,PL22,75194,75054,316,176,140
2021-06-14,SD,13,PL17,75636,74668,1144,176,968
2021-06-13,SD,13,PL21,48677,48205,4680,4208,472
2021-06-03,HO,18,PL10,57648,57688,0,0,0
2021-12-19,EC,10,PL43,631344,631776,0,0,0
2021-09-19,SB,11,PL50,460416,459744,1472,1472,0
2021-01-12,CA,23,PL02,237552,234744,2928,2928,0
2021-02-23,CH,24,PL04,164832,164560,272,272,0
2021-06-10,DI,19,PL52,290208,288736,1664,1664,0
2021-09-23,RT,21,PL06,203616,203112,816,816,0
2021-01-31,SD,13,PL22,71380,70962,626,192,434
2021-05-29,EC,10,PL43,600240,597024,3744,3744,0
2021-07-29,CH,24,PL07,296892,280987,20769,4864,15905
2021-05-05,SB,11,PL50,445600,444704,2240,2240,0
2021-05-19,CA,23,PL02,229536,227376,2568,2568,0
2021-09-13,SD,13,PL17,20403,20197,3039,2832,207
2021-03-09,CA,23,PL02,231816,231168,1008,1008,0
2021-01-07,RT,21,PL05,200136,199152,1200,1200,0
2021-05-18,SB,11,PL50,106336,103264,3072,3072,0
2021-01-25,HO,18,PL30,65056,64920,136,136,0
2021-09-17,PRG,12,PL14,388640,386432,2784,2784,0
2021-02-25,RT,21,PL06,189456,189192,1080,1080,0
2021-06-14,SD,13,PL21,67563,66851,5960,5248,712
2021-11-12,SD,13,PL25,74396,73293,1528,400,1128
2021-05-25,RA,17,PL56,142872,142464,744,744,0
2021-02-28,CA,23,PL31,204912,201576,3336,3336,0
2021-04-06,HO,18,PL03,64352,64200,152,152,0
2021-10-24,PRG,12,PL14,392928,392448,800,800,0
2021-03-09,CL,14,PL44,13536,9632,3616,3616,0
2021-04-19,PR,15,PL24,150400,146272,4384,4384,0
2021-04-26,SB,11,PL50,310080,308448,2112,2112,0
2021-06-19,CH,24,PL08,176945,151729,51214,18880,32334
2021-05-21,HO,18,PL01,62688,61728,1016,1016,0
2021-01-14,NT,16,PL51,471360,470880,1056,1056,0
2021-02-26,CH,24,PL04,164576,163232,1344,1344,0
2021-02-07,PRG,12,PL12,393088,392256,1120,1120,0
2021-06-30,RT,21,PL05,184320,184248,1992,1992,0
2021-04-15,DI,19,PL52,205664,200640,5024,5024,0
2021-11-19,RT,21,PL05,13056,0,13056,13056,0
2021-10-07,PR,15,PL24,266368,266656,512,512,0
2021-03-13,SD,13,PL22,68573,68428,1170,1008,162
2021-12-19,PW,26,PL37,819264,816960,3696,3696,0
2021-01-02,PR,15,PL04,0,0,1248,1248,0
2021-09-26,RT,21,PL05,206376,206136,528,528,0
2021-04-30,PRG,12,PL14,25888,25888,0,0,0
2021-05-15,NT,16,PL51,436128,436128,8000,8000,0
2021-06-05,CL,14,PL45,52800,48640,2784,2784,0
2021-07-09,PR,15,PL24,261856,261376,832,832,0
2021-09-11,HO,18,PL09,72248,72328,112,112,0
2021-02-21,EC,10,PL43,625776,625968,576,576,0
2021-04-15,RA,17,PL34,219120,218280,912,912,0
2021-08-12,HO,18,PL01,36344,36168,336,336,0
2021-09-12,CH,24,PL12,164704,162992,1712,1712,0
2021-01-02,CH,24,PL57,9204,9184,52,52,0
2021-03-28,CH,24,PL07,273281,258560,20923,6048,14875
2021-08-09,HO,18,PL11,66200,66256,0,0,0
2021-05-16,HO,18,PL32,59632,59496,136,136,0
2021-07-23,PB,25,PL55,444928,442176,3136,3136,0
2021-09-15,CA,23,PL13,76896,76720,552,552,0
2021-08-17,CH,24,PL57,11768,11628,140,140,0
2021-11-15,RA,17,PL34,139416,137928,1488,1488,0
2021-02-11,SB,11,PL36,214056,213240,7344,7344,0
2021-08-07,CL,14,PL44,250272,218560,13312,13312,0
2021-09-10,EC,10,PL43,604368,601872,3168,3168,0
2021-07-12,PRG,12,PL14,270912,270880,32,32,0
2021-06-26,RA,17,PL35,223920,223128,792,792,0
2021-11-12,HO,18,PL01,67448,67224,256,256,0
2021-12-14,PRG,12,PL14,318144,315872,3392,3392,0
2021-09-17,CH,24,PL12,147344,147456,432,432,0
2021-05-06,PR,15,PL04,263712,263712,448,448,0
2021-10-09,CA,23,PL31,0,0,1344,1344,0
2021-10-03,HO,18,PL56,66032,65504,528,528,0
2021-07-04,PR,15,PL12,136928,136768,176,176,0
2021-09-14,HO,18,PL30,0,0,1088,1088,0
2021-12-20,SD,13,PL25,75065,74643,614,192,422
2021-01-23,SB,11,PL36,314280,314208,888,888,0
2021-08-01,CH,24,PL07,289566,280613,15417,6464,8953
2021-07-24,HO,18,PL01,36576,36256,328,328,0
2021-02-01,SB,11,PL36,315336,314352,984,984,0
2021-02-24,CA,23,PL02,236208,235488,1128,1128,0
2021-09-01,SD,13,PL21,64551,63967,2312,1728,584
2021-03-28,RT,21,PL42,190880,188864,2288,2288,0
2021-09-05,HO,18,PL33,130112,130096,400,400,0
2021-09-07,DI,19,PL52,293728,293056,1152,1152,0
2021-01-23,SD,13,PL22,70606,69881,967,176,791
2021-10-23,SD,13,PL21,59676,59411,669,384,285
2021-01-19,CH,24,PL08,295260,285134,17634,7360,10274
2021-05-07,SB,11,PL36,290520,289104,1704,1704,0
2021-07-08,HO,18,PL03,66680,66616,112,112,0
2021-09-26,HO,18,PL11,65448,65064,464,464,0
2021-09-09,SB,11,PL36,261936,261120,2664,2664,0
2021-02-09,CH,24,PL07,194141,170173,28024,3968,24056
2021-07-19,HO,18,PL56,65152,65152,200,200,0
2021-01-22,RA,17,PL34,218760,216984,1776,1776,0
2021-03-20,SD,13,PL20,54116,53865,2235,1984,251
2021-07-04,RT,21,PL05,204480,203760,720,720,0
2021-06-07,SD,13,PL19,76731,76563,344,176,168
2021-07-14,SD,13,PL18,71694,71445,3321,3072,249
2021-07-16,HO,18,PL30,66136,66176,0,0,0
2021-01-09,CA,23,PL31,55008,53592,1416,1416,0
2021-01-19,RT,21,PL05,192504,191208,1416,1416,0
2021-02-10,HO,18,PL30,66160,66160,0,0,0
2021-11-04,NT,16,PL51,71584,70976,1088,1088,0
2021-11-23,HO,18,PL01,65760,64880,880,880,0
2021-01-28,PR,15,PL24,265248,256832,8736,8736,0
2021-05-01,SD,13,PL19,74067,74076,1130,1088,42
2021-09-08,RT,21,PL41,165552,161408,4144,4144,0
2021-04-27,SD,13,PL25,44535,44333,570,368,202
2021-06-08,CH,24,PL07,223518,209766,17798,3968,13830
2021-07-28,HO,18,PL10,0,0,624,624,0
2021-02-08,CA,23,PL02,225720,214584,11280,11280,0
2021-08-16,RT,21,PL42,177696,175568,2288,2288,0
2021-02-23,CA,23,PL02,235656,235488,408,408,0
2021-05-28,PB,25,PL54,449472,448992,736,736,0
2021-11-28,SD,13,PL20,75814,75685,516,352,164
2021-01-13,CH,24,PL07,0,0,6,0,6
2021-02-12,PRG,12,PL14,392256,392128,736,736,0
2021-10-30,PRG,12,PL14,306112,298496,7840,7840,0
2021-11-11,CL,14,PL44,294912,288224,6112,6112,0
2021-06-14,SD,13,PL22,60813,60728,453,368,85
2021-06-27,HO,18,PL33,132480,132480,0,0,0
2021-06-06,SD,13,PL18,69526,67861,1843,176,1667
2021-03-14,CA,23,PL13,85400,85432,96,96,0
2021-11-17,CL,14,PL45,294912,280032,4032,4032,0
2021-04-30,SB,11,PL36,252720,250224,2496,2496,0
2021-12-07,HO,18,PL10,69376,69376,0,0,0
2021-08-21,CH,24,PL08,329342,295955,37419,4032,33387
2021-10-04,RT,21,PL41,63152,52128,11088,11088,0
2021-11-17,CH,24,PL07,308138,293501,18260,3488,14772
2021-01-28,SD,13,PL22,60604,60257,539,192,347
2021-05-06,HO,18,PL33,57328,55328,2056,2056,0
2021-09-16,SD,13,PL17,71678,70375,2039,736,1303
2021-11-24,RT,21,PL05,125088,120168,4920,4920,0
2021-01-20,HO,18,PL33,67984,67816,168,168,0
2021-01-14,PRG,12,PL14,387680,387424,832,832,0
2021-02-05,RT,21,PL42,110368,103840,6736,6736,0
2021-03-13,CL,14,PL44,300608,297568,1504,1504,0
2021-06-12,SD,13,PL18,75291,74742,1517,944,573
2021-10-09,CH,24,PL12,165072,164912,160,160,0
2021-03-23,CL,14,PL45,289408,278336,2464,2464,0
2021-07-16,CL,14,PL45,263488,258080,3712,3712,0
2021-10-30,SD,13,PL17,19366,19251,2926,2608,318
2021-05-29,HO,18,PL09,72104,72064,88,88,0
2021-02-25,DI,19,PL52,295104,294368,1472,1472,0
2021-08-23,PR,15,PL04,349632,348576,1440,1440,0
2021-12-15,RA,17,PL34,170544,168624,1920,1920,0
2021-10-24,HO,18,PL33,132528,132528,0,0,0
2021-10-11,CH,24,PL07,315131,300025,18658,3552,15106
2021-04-01,HO,18,PL10,56960,56928,88,88,0
2021-07-30,SD,13,PL20,76278,76242,228,192,36
2021-08-12,SD,13,PL25,76750,76330,596,176,420
2021-02-02,CL,14,PL45,101824,97632,1280,1280,0
2021-02-09,NT,16,PL51,428896,427072,2880,2880,0
2021-11-15,RT,21,PL41,140176,136448,3920,3920,0
2021-03-19,HO,18,PL32,68024,67808,216,216,0
2021-01-09,CH,24,PL08,249985,237085,28348,15392,12956
2021-10-07,HO,18,PL56,65256,64928,368,368,0
2021-11-28,HO,18,PL32,57568,57632,0,0,0
2021-02-15,PB,25,PL54,71808,71808,0,0,0
2021-09-25,CA,23,PL13,85024,85024,112,112,0
2021-11-13,SD,13,PL20,74872,74694,562,384,178
2021-11-01,HO,18,PL56,64184,64064,240,240,0
2021-12-14,CH,24,PL12,152528,149840,2688,2688,0
2021-06-18,CH,24,PL57,33912,33872,88,88,0
2021-12-03,HO,18,PL33,72328,72272,96,96,0
2021-02-04,CL,14,PL45,294624,285216,4320,4320,0
2021-06-30,SD,13,PL25,65476,64971,1948,1392,556
2021-10-11,SD,13,PL21,57471,57149,987,640,347
2021-07-03,CL,14,PL45,296896,293152,1632,1632,0
2021-07-17,HO,18,PL30,64928,64760,240,240,0
2021-09-05,HO,18,PL11,66216,66288,0,0,0
2021-07-12,HO,18,PL32,67744,67680,96,96,0
2021-03-25,RT,21,PL05,205536,205368,504,504,0
2021-03-14,RT,21,PL05,209760,210000,0,0,0
2021-07-28,CH,24,PL08,220277,212886,11487,4096,7391
2021-01-30,EC,10,PL43,621696,620880,1008,1008,0
2021-12-13,CH,24,PL07,57,57,2944,2944,0
2021-07-30,PW,26,PL37,784272,771264,13968,13968,0
2021-01-24,EC,10,PL43,617568,618432,2640,2640,0
2021-10-08,PW,26,PL37,811728,806544,7872,7872,0
2021-08-05,CA,23,PL31,231768,231480,960,960,0
2021-09-26,HO,18,PL56,63504,62536,968,968,0
2021-03-25,SD,13,PL21,73070,72652,789,368,421
2021-07-31,HO,18,PL03,66472,66384,96,96,0
2021-06-30,PR,15,PL12,138784,138608,336,336,0
2021-12-08,RA,17,PL56,252360,251904,936,936,0
2021-10-11,EC,10,PL43,625968,625200,576,576,0
2021-04-08,SD,13,PL18,71931,71796,773,544,229
2021-07-09,RT,21,PL42,189152,186448,2864,2864,0
2021-02-03,PW,26,PL37,595008,595008,4416,4416,0
2021-06-17,PR,15,PL04,260256,254912,5408,5408,0
2021-12-08,EC,10,PL43,610272,609072,1296,1296,0
2021-06-09,CL,14,PL44,158368,148736,5632,5632,0
2021-05-05,HO,18,PL32,67672,67568,160,160,0
2021-12-07,EC,10,PL43,624096,624432,576,576,0
2021-01-13,PRG,12,PL12,392032,391712,800,800,0
2021-11-08,HO,18,PL03,66768,66736,160,160,0
2021-04-11,PR,15,PL57,142112,140912,1312,1312,0
2021-06-12,HO,18,PL33,132480,132480,0,0,0
2021-05-27,SD,13,PL18,58975,58253,3004,2256,748
2021-05-27,SD,13,PL25,73628,73549,1162,192,970
2021-12-19,CA,23,PL02,231384,231264,864,864,0
2021-06-12,CA,23,PL11,230112,229824,912,912,0
2021-06-16,SD,13,PL25,62859,62131,8860,8112,748
2021-05-15,DI,19,PL53,285920,283840,2304,2304,0
2021-01-07,SD,13,PL22,70904,70560,536,192,344
2021-05-27,RT,21,PL06,209304,209448,0,0,0
2021-06-09,HO,18,PL09,66304,66368,96,96,0
2021-03-31,PR,15,PL24,132352,132192,160,160,0
2021-01-22,SD,13,PL18,69071,69010,1514,1360,154
2021-09-23,DI,19,PL52,288992,285408,3840,3840,0
2021-06-07,SD,13,PL17,66070,63603,2659,192,2467
2021-11-21,SD,13,PL19,57933,57773,368,208,160
2021-10-11,RT,21,PL05,201216,200112,1344,1344,0
2021-01-12,HO,18,PL11,66096,66016,112,112,0
2021-06-18,CA,23,PL02,231480,231144,600,600,0
2021-11-02,SD,13,PL19,76010,75928,595,480,115
2021-04-12,SD,13,PL20,70228,69655,1581,1008,573
2021-05-01,RT,21,PL42,10768,0,10768,10768,0
2021-01-14,PR,15,PL24,264064,263360,1088,1088,0
2021-12-16,PW,26,PL37,806304,804912,3984,3984,0
2021-12-21,HO,18,PL09,66240,66144,96,96,0
2021-01-10,RT,21,PL05,205488,204600,1008,1008,0
2021-09-25,RT,21,PL06,205320,205224,384,384,0
2021-10-05,HO,18,PL33,132336,132336,0,0,0
2021-04-29,SD,13,PL22,71447,70713,1491,752,739
2021-01-20,RT,21,PL06,209688,209904,24,24,0
2021-03-13,SD,13,PL19,70103,69709,3121,2672,449
2021-09-09,CH,24,PL12,163056,161760,1488,1488,0
2021-10-20,PRG,12,PL14,396576,396832,128,128,0
2021-03-01,DI,19,PL52,195712,195424,288,288,0
2021-01-19,RA,17,PL56,133776,131616,2256,2256,0
2021-04-19,CA,23,PL31,0,0,0,0,0
2021-02-04,HO,18,PL33,67752,67576,176,176,0
2021-10-14,CH,24,PL07,300625,296782,12643,8800,3843
2021-01-02,HO,18,PL03,49608,49544,64,64,0
2021-08-15,HO,18,PL09,70424,70384,312,312,0
2021-06-23,HO,18,PL32,67432,67408,104,104,0
2021-07-02,SD,13,PL17,46204,45306,2100,1184,916
2021-02-28,CH,24,PL08,195829,186197,27693,17632,10061
2021-10-15,SD,13,PL17,47097,46920,561,384,177
2021-12-09,PRG,12,PL14,392704,391424,1792,1792,0
2021-06-26,CL,14,PL45,300352,298432,1280,1280,0
2021-07-06,CA,23,PL02,236064,236352,312,312,0
2021-11-04,CH,24,PL24,164096,164144,176,176,0
2021-03-17,PRG,12,PL14,208096,204064,4640,4640,0
2021-06-15,PRG,12,PL14,381600,380096,1504,1504,0
2021-04-28,HO,18,PL10,46152,44120,2344,2344,0
2021-05-06,EC,10,PL43,148128,125472,17360,17360,0
2021-03-20,CA,23,PL02,109752,107232,2496,2496,0
2021-05-17,SB,11,PL50,10176,10080,0,0,0
2021-05-06,HO,18,PL03,66296,66288,0,0,0
2021-04-28,CH,24,PL07,102963,100224,13299,10560,2739
2021-03-16,PR,15,PL24,264256,264352,608,608,0
2021-09-28,SD,13,PL18,72439,71684,1360,544,816
2021-01-20,HO,18,PL11,66280,66280,0,0,0
2021-10-08,CH,24,PL08,271762,270117,5645,4000,1645
2021-04-20,CA,23,PL13,65160,65008,576,576,0
2021-08-23,CH,24,PL08,264755,245480,21995,2720,19275
2021-12-17,PRG,12,PL14,385344,379072,6592,6592,0
2021-09-29,HO,18,PL03,67048,66992,96,96,0
2021-05-08,RT,21,PL05,207384,207168,264,264,0
2021-06-07,SD,13,PL18,16907,15204,5403,3568,1835
2021-08-13,HO,18,PL10,68680,68608,176,176,0
2021-07-05,SD,13,PL21,6208,6184,352,16,336
2021-06-22,DI,19,PL52,293856,293280,1056,1056,0
2021-10-08,CA,23,PL13,85384,85248,248,248,0
2021-11-23,CA,23,PL13,69200,69128,176,176,0
2021-09-21,NT,16,PL51,514432,514016,736,736,0
2021-03-11,SB,11,PL50,367744,365856,4864,4864,0
2021-11-06,HO,18,PL56,66232,66224,0,0,0
2021-04-26,SB,11,PL36,308928,307848,1464,1464,0
2021-07-06,RT,21,PL42,184048,180976,3040,3040,0
2021-05-31,PR,15,PL12,139472,139248,352,352,0
2021-06-05,CH,24,PL08,289165,275098,23355,9184,14171
2021-10-04,CH,24,PL07,289325,273586,20411,4672,15739
2021-07-08,CL,14,PL45,296672,293312,2560,2560,0
2021-10-09,PR,15,PL04,260160,255712,4448,4448,0
2021-02-04,HO,18,PL11,55872,55376,504,504,0
2021-03-30,RT,21,PL06,202944,202080,864,864,0
2021-06-03,HO,18,PL01,52256,51336,920,920,0
2021-10-12,SD,13,PL17,73947,73752,371,176,195
2021-08-09,HO,18,PL40,59304,59056,248,248,0
2021-07-05,HO,18,PL33,65488,65288,200,200,0
2021-09-29,CH,24,PL08,248673,223114,33614,7616,25998
2021-10-20,CH,24,PL57,34220,34156,64,64,0
2021-03-25,SD,13,PL17,74082,73225,1049,192,857
2021-08-24,HO,18,PL01,67176,66224,1048,1048,0
2021-11-06,HO,18,PL03,65216,65120,96,96,0
2021-09-17,CL,14,PL45,255904,249568,5280,5280,0
2021-06-12,PR,15,PL24,264128,264064,448,448,0
2021-06-19,RT,21,PL05,206784,206400,360,360,0
2021-12-06,HO,18,PL09,65080,64920,216,216,0
2021-09-23,SD,13,PL20,60024,59976,2121,2048,73
2021-10-11,CH,24,PL57,32864,32540,552,552,0
2021-10-06,CA,23,PL02,228288,228048,384,384,0
2021-10-23,HO,18,PL32,57640,57640,0,0,0
2021-03-15,PB,25,PL55,286624,274336,12736,12736,0
2021-08-18,RT,21,PL06,0,0,0,0,0
2021-01-21,PRG,12,PL12,276832,271296,5536,5536,0
2021-09-25,HO,18,PL32,56624,56528,96,96,0
2021-09-21,SD,13,PL25,74464,74054,1400,976,424
2021-10-12,DI,19,PL52,291072,291104,384,384,0
2021-09-06,HO,18,PL03,67008,66888,120,120,0
2021-11-24,SB,11,PL50,456384,455904,992,992,0
2021-05-28,CH,24,PL57,22936,22888,48,48,0
2021-11-16,SD,13,PL17,6278,6261,18,0,18
2021-06-14,CH,24,PL57,23872,23852,40,40,0
2021-12-08,HO,18,PL01,66888,65816,1168,1168,0
2021-04-16,EC,10,PL43,615216,614832,624,624,0
2021-10-13,HO,18,PL09,4360,4360,0,0,0
2021-02-24,RT,21,PL05,204216,203832,384,384,0
2021-12-01,HO,18,PL03,66224,66224,0,0,0
2021-05-23,EC,10,PL43,611568,608928,3072,3072,0
2021-03-19,CL,14,PL45,175616,147808,7456,7456,0
2021-09-23,CH,24,PL12,164240,164256,208,208,0
2021-09-15,SB,11,PL50,456576,455424,3008,3008,0
2021-05-05,CA,23,PL11,230208,228840,1728,1728,0
2021-02-23,PRG,12,PL14,393056,392768,832,832,0
2021-03-08,CA,23,PL13,71848,71528,432,432,0
2021-04-28,HO,18,PL09,3416,3360,56,56,0
2021-06-11,PR,15,PL12,138928,138704,224,224,0
2021-10-09,CH,24,PL57,33916,33856,88,88,0
2021-05-27,RT,21,PL42,191232,190144,3008,3008,0
2021-09-13,CH,24,PL57,33028,32992,388,388,0
2021-11-06,CA,23,PL02,230904,230064,1104,1104,0
2021-06-03,CL,14,PL44,215008,210272,6144,6144,0
2021-01-31,HO,18,PL10,54888,54840,88,88,0
2021-07-19,PB,25,PL55,448288,448960,736,736,0
2021-08-01,CA,23,PL31,228624,226320,2424,2424,0
2021-02-18,RA,17,PL34,220608,220464,360,360,0
2021-06-06,RT,21,PL06,23328,23472,0,0,0
2021-01-24,CA,23,PL02,239496,238992,648,648,0
2021-06-10,CA,23,PL11,234000,232656,1440,1440,0
2021-02-06,PW,26,PL37,481248,299904,183936,183936,0
2021-04-20,CA,23,PL02,232680,232320,864,864,0
2021-08-17,EC,10,PL43,0,0,6048,6048,0
2021-08-11,PRG,12,PL14,214944,214144,1056,1056,0
2021-09-05,CA,23,PL13,73368,73400,288,288,0
2021-12-05,EC,10,PL43,618192,617280,1440,1440,0
2021-11-04,HO,18,PL10,46344,46040,304,304,0
2021-05-28,SD,13,PL21,72862,72525,689,352,337
2021-10-24,HO,18,PL32,56880,56800,88,88,0
2021-02-19,SD,13,PL17,54039,53703,1587,1216,371
2021-02-27,CL,14,PL45,286944,266240,4992,4992,0
2021-01-25,CL,14,PL45,238368,221984,0,0,0
2021-12-10,CA,23,PL35,70120,69968,96,96,0
2021-05-03,HO,18,PL33,65136,65208,136,136,0
2021-09-20,PB,25,PL54,0,0,0,0,0
2021-04-01,HO,18,PL03,66248,66248,0,0,0
2021-12-06,HO,18,PL01,66088,65080,1008,1008,0
2021-09-22,PW,26,PL37,782064,631776,150720,150720,0
2021-09-10,CL,14,PL45,284288,280864,2816,2816,0
2021-12-20,EC,10,PL43,608256,606816,1248,1248,0
2021-01-07,HO,18,PL32,66224,66224,0,0,0
2021-08-04,PRG,12,PL14,0,0,42464,42464,0
2021-07-26,HO,18,PL40,66256,66080,176,176,0
2021-02-05,CA,23,PL02,234120,228648,5664,5664,0
2021-03-28,SB,11,PL50,454048,453024,2048,2048,0
2021-05-02,EC,10,PL43,106768,104368,2592,2592,0
2021-09-22,CL,14,PL45,290080,284288,4480,4480,0
2021-08-16,CH,24,PL07,270134,249803,36683,16352,20331
2021-09-11,DI,19,PL52,286272,272000,14848,14848,0
2021-04-13,CA,23,PL31,195096,192384,3096,3096,0
2021-10-30,CH,24,PL57,29252,29128,716,716,0
2021-05-27,HO,18,PL03,31008,29216,1792,1792,0
2021-08-03,HO,18,PL33,66136,66200,0,0,0
2021-08-03,EC,10,PL43,625104,622560,2304,2304,0
2021-06-04,CH,24,PL07,272938,260588,18494,6144,12350
2021-06-12,HO,18,PL32,68024,67864,160,160,0
2021-07-20,SD,13,PL18,12715,12667,4932,4768,164
2021-05-22,CH,24,PL57,6532,6164,368,368,0
2021-09-11,RT,21,PL05,204288,204240,720,720,0
2021-02-18,SB,11,PL50,413824,411040,4352,4352,0
2021-01-23,RT,21,PL06,209688,209760,168,168,0
2021-06-19,PRG,12,PL14,392096,390784,1568,1568,0
2021-03-30,CA,23,PL02,156744,152832,4104,4104,0
2021-02-10,SD,13,PL25,69772,68292,2063,560,1503
2021-02-18,PW,26,PL37,783264,779952,4512,4512,0
2021-01-13,HO,18,PL33,68624,68712,0,0,0
2021-10-31,RT,21,PL42,188400,178592,9936,9936,0
2021-08-17,RA,17,PL35,58800,58800,0,0,0
2021-09-20,CH,24,PL57,33744,33732,112,112,0
2021-12-13,CH,24,PL12,164608,164400,208,208,0
2021-04-29,CA,23,PL02,228744,228360,864,864,0
2021-05-28,RT,21,PL05,156840,156480,1104,1104,0
2021-04-10,CA,23,PL31,171600,166872,4920,4920,0
2021-06-23,PB,25,PL54,413984,392480,22112,22112,0
2021-10-13,RT,21,PL06,208872,208608,264,264,0
2021-09-11,NT,16,PL51,463872,443712,20864,20864,0
2021-10-10,EC,10,PL43,610464,609216,1632,1632,0
2021-10-06,SD,13,PL20,72786,72235,1303,752,551
2021-09-21,DI,19,PL53,298272,298528,0,0,0
2021-03-30,NT,16,PL51,468992,467264,2048,2048,0
2021-10-10,DI,19,PL52,221280,218528,3008,3008,0
2021-01-27,HO,18,PL03,60496,60360,216,216,0
2021-03-12,RA,17,PL35,215784,214248,1680,1680,0
2021-07-29,HO,18,PL01,66640,65448,1192,1192,0
2021-05-30,CA,23,PL11,231192,228096,3360,3360,0
2021-12-06,RT,21,PL06,204096,203616,552,552,0
2021-09-04,DI,19,PL53,295392,295712,384,384,0
2021-12-03,CA,23,PL02,152520,152064,648,648,0
2021-03-21,HO,18,PL33,66224,66224,0,0,0
2021-04-08,HO,18,PL10,57136,57056,80,80,0
2021-01-07,CH,24,PL08,243817,230078,20001,6048,13953
2021-01-19,PW,26,PL37,511440,343680,167760,167760,0
2021-11-27,SD,13,PL21,62137,61854,738,416,322
2021-07-18,HO,18,PL56,66184,65992,192,192,0
2021-09-29,EC,10,PL43,624288,622272,2352,2352,0
2021-10-26,CA,23,PL13,85488,85648,96,96,0
2021-05-10,HO,18,PL33,66080,65896,184,184,0
2021-05-12,NT,16,PL51,437952,437568,704,704,0
2021-03-17,CL,14,PL45,1696,1344,8384,8384,0
2021-05-04,DI,19,PL53,292416,291616,928,928,0
2021-11-13,RT,21,PL41,169184,166528,2848,2848,0
2021-12-23,EC,10,PL43,102720,102576,48,48,0
2021-04-05,RT,21,PL42,183840,180096,4000,4000,0
2021-01-25,SD,13,PL22,69649,69296,570,176,394
2021-01-25,RT,21,PL05,193896,189240,4656,4656,0
2021-03-29,PB,25,PL54,430944,334496,97248,97248,0
2021-04-20,HO,18,PL30,66224,66224,0,0,0
2021-06-18,SB,11,PL50,449568,447552,2432,2432,0
2021-02-15,CA,23,PL02,232968,231456,2280,2280,0
2021-03-28,RA,17,PL56,190776,187584,3744,3744,0
2021-07-01,HO,18,PL33,0,0,312,312,0
2021-01-24,CL,14,PL44,304256,293184,3264,3264,0
2021-02-03,CA,23,PL13,84944,84312,904,904,0
2021-05-26,DI,19,PL52,290272,289056,1696,1696,0
2021-06-13,HO,18,PL32,67336,67304,112,112,0
2021-11-27,RT,21,PL42,6992,5888,1104,1104,0
2021-05-12,SD,13,PL17,62309,61614,1517,816,701
2021-03-14,SD,13,PL21,57996,57229,1267,464,803
2021-04-11,RT,21,PL42,165888,162192,3696,3696,0
2021-03-17,NT,16,PL57,153856,153696,560,560,0
2021-12-12,PR,15,PL04,262336,261920,672,672,0
2021-11-25,HO,18,PL33,63136,63000,232,232,0
2021-08-22,HO,18,PL03,66672,66664,96,96,0
2021-10-25,CA,23,PL13,85456,85392,88,88,0
2021-09-08,RT,21,PL05,197736,196536,1488,1488,0
2021-01-22,PR,15,PL24,264384,262304,2080,2080,0
2021-05-03,CH,24,PL08,307660,302825,9667,4832,4835
2021-12-23,NT,16,PL57,150368,150368,0,0,0
2021-09-08,SD,13,PL19,73289,73244,2893,2832,61
2021-02-16,RA,17,PL35,120072,115992,5808,5808,0
2021-07-01,DI,19,PL53,293824,292128,1888,1888,0
2021-05-01,RT,21,PL06,209352,209184,408,408,0
2021-09-06,CA,23,PL31,203208,200640,2688,2688,0
2021-03-13,PR,15,PL24,265440,264448,992,992,0
2021-07-29,SD,13,PL25,65542,64153,2013,624,1389
2021-10-10,SD,13,PL22,75273,75197,460,384,76
2021-01-14,SD,13,PL20,51915,45562,8129,1776,6353
2021-01-13,PR,15,PL24,264448,263424,1248,1248,0
2021-08-16,RT,21,PL05,206640,206520,288,288,0
2021-02-28,HO,18,PL01,65944,65336,632,632,0
2021-09-05,DI,19,PL53,295264,292192,3168,3168,0
2021-03-15,DI,19,PL52,299392,299200,448,448,0
2021-10-05,RA,17,PL34,262704,259656,3384,3384,0
2021-10-27,CH,24,PL08,216917,199377,26436,8896,17540
2021-11-30,HO,18,PL30,143632,140240,3280,3280,0
2021-07-07,RT,21,PL05,164760,163704,1200,1200,0
2021-06-12,PB,25,PL55,446912,445856,2976,2976,0
2021-06-13,CA,23,PL02,235824,235656,408,408,0
2021-12-17,RT,21,PL42,56032,49456,17728,17728,0
2021-01-03,SD,13,PL17,73068,72997,263,192,71
2021-01-26,EC,10,PL43,621120,620160,1056,1056,0
2021-06-05,CA,23,PL31,227976,225192,2904,2904,0
2021-07-13,RT,21,PL05,208296,208584,0,0,0
2021-09-30,HO,18,PL09,67040,66856,296,296,0
2021-02-17,PRG,12,PL12,393696,393312,768,768,0
2021-12-14,RA,17,PL34,238656,237504,1200,1200,0
2021-06-11,DI,19,PL52,293344,292544,1248,1248,0
2021-11-17,HO,18,PL01,47656,46072,1584,1584,0
2021-03-03,DI,19,PL52,296576,296832,352,352,0
2021-08-06,SD,13,PL19,64848,64604,1371,1136,235
2021-11-07,CL,14,PL44,300576,298944,1248,1248,0
2021-07-05,SD,13,PL20,74455,74426,381,352,29
2021-10-13,CH,24,PL12,143456,143040,1088,1088,0
2021-05-10,CL,14,PL45,296096,291968,3904,3904,0
2021-11-28,PRG,12,PL14,392704,393056,800,800,0
2021-03-06,SD,13,PL21,69939,68559,1586,192,1394
2021-10-28,HO,18,PL40,6328,6328,0,0,0
2021-04-29,DI,19,PL52,200064,195424,4992,4992,0
2021-09-16,SB,11,PL50,450016,448384,2336,2336,0
2021-03-01,HO,18,PL32,67344,67256,88,88,0
2021-10-22,CL,14,PL45,284576,274976,8768,8768,0
2021-01-08,CA,23,PL31,234384,234096,480,480,0
2021-01-31,PR,15,PL24,262912,259680,3552,3552,0
2021-06-12,CL,14,PL44,288608,277280,6464,6464,0
2021-06-08,PB,25,PL55,167360,165376,2400,2400,0
2021-11-19,HO,18,PL10,296,296,88,88,0
2021-02-14,RA,17,PL34,216480,215832,1272,1272,0
2021-06-18,CH,24,PL08,239688,235223,14513,10048,4465
2021-03-30,RT,21,PL05,202536,202008,528,528,0
2021-01-12,HO,18,PL03,66800,66544,280,280,0
2021-09-06,HO,18,PL09,9064,9064,280,280,0
2021-07-12,CL,14,PL45,293728,291456,2336,2336,0
2021-11-15,PB,25,PL54,360224,341376,19072,19072,0
2021-09-20,PW,26,PL37,777216,771024,8592,8592,0
2021-08-28,PRG,12,PL14,392960,392096,1600,1600,0
2021-01-26,HO,18,PL11,60896,60288,608,608,0
2021-08-05,CL,14,PL45,264064,260544,3040,3040,0
2021-12-01,PW,26,PL37,759648,759360,1824,1824,0
2021-05-17,HO,18,PL30,59504,59328,264,264,0
2021-01-18,CH,24,PL57,34104,34080,44,44,0
2021-03-09,HO,18,PL33,67424,67448,96,96,0
2021-10-24,SD,13,PL18,75941,75311,982,352,630
2021-02-11,PRG,12,PL14,390496,390144,1280,1280,0
2021-07-01,CA,23,PL11,159960,158208,2760,2760,0
2021-09-05,SD,13,PL21,71621,71305,604,208,396
2021-05-12,SD,13,PL19,58488,58458,681,656,25
2021-10-19,PR,15,PL04,260064,258208,1952,1952,0
2021-01-20,HO,18,PL01,50192,49504,688,688,0
2021-12-12,DI,19,PL53,290752,278144,12800,12800,0
2021-05-01,PW,26,PL37,778464,771936,7344,7344,0
2021-03-12,RA,17,PL56,186192,179616,7632,7632,0
2021-10-07,HO,18,PL32,56632,56664,88,88,0
2021-12-10,SD,13,PL18,56833,56264,5097,4528,569
2021-10-03,SD,13,PL22,64497,64427,6054,5984,70
2021-01-11,HO,18,PL09,62472,62440,264,264,0
2021-02-20,SD,13,PL22,69379,69296,559,400,159
2021-09-10,SB,11,PL50,453760,452416,1824,1824,0
2021-05-27,PW,26,PL37,621600,620112,2208,2208,0
2021-08-01,SD,13,PL20,76440,76389,243,176,67
2021-08-01,SD,13,PL19,59538,59488,428,352,76
2021-11-26,HO,18,PL11,66264,66168,96,96,0
2021-02-14,DI,19,PL52,294592,294432,384,384,0
2021-12-09,CH,24,PL07,299756,293533,16995,5504,11491
2021-05-29,PR,15,PL12,139184,139056,480,480,0
2021-03-03,HO,18,PL09,71992,71904,88,88,0
2021-05-05,EC,10,PL43,62432,55056,1136,1136,0
2021-07-13,HO,18,PL32,68432,68184,248,248,0
2021-02-05,SD,13,PL17,72977,71703,1642,368,1274
2021-03-25,SD,13,PL25,71139,70996,735,576,159
2021-05-07,CH,24,PL57,33052,32968,84,84,0
2021-10-06,HO,18,PL56,65464,64728,752,752,0
2021-06-01,PRG,12,PL14,280000,279680,1056,1056,0
2021-09-16,SD,13,PL25,62201,61609,1271,560,711
2021-04-13,PR,15,PL24,249088,246464,3328,3328,0
2021-09-16,SD,13,PL18,43438,43222,6811,6560,251
2021-11-29,SD,13,PL17,60923,60437,679,192,487
2021-12-08,RT,21,PL05,80256,79944,1632,1632,0
2021-12-18,PB,25,PL54,448832,444288,4224,4224,0
2021-03-03,HO,18,PL33,67896,67792,104,104,0
2021-10-15,PB,25,PL55,372928,353120,21888,21888,0
2021-04-06,DI,19,PL52,280640,280480,5312,5312,0
2021-04-13,HO,18,PL09,71128,70136,1104,1104,0
2021-10-23,CA,23,PL02,160128,158832,1920,1920,0
2021-03-09,RA,17,PL56,221880,221376,600,600,0
2021-04-12,PB,25,PL55,47776,41536,10432,10432,0
2021-06-15,SB,11,PL36,225672,207840,17832,17832,0
2021-10-31,CH,24,PL12,143840,143632,208,208,0
2021-08-14,RT,21,PL05,164328,164088,240,240,0
2021-02-19,EC,10,PL43,623232,621600,1776,1776,0
2021-05-15,PB,25,PL55,448736,447072,2176,2176,0
2021-07-24,CH,24,PL08,196241,188938,9135,1824,7311
2021-07-22,PW,26,PL37,789792,698976,94992,94992,0
2021-06-25,CH,24,PL08,282963,277596,10281,4896,5385
2021-01-27,SD,13,PL22,57130,56778,3235,2880,355
2021-03-02,CH,24,PL07,241706,229169,30976,18208,12768
2021-04-07,PB,25,PL54,425760,416000,10784,10784,0
2021-05-24,PRG,12,PL14,0,0,0,0,0
2021-05-27,HO,18,PL40,43648,43608,728,728,0
2021-11-25,RT,21,PL05,131616,116472,18720,18720,0
2021-01-20,SD,13,PL19,62072,61766,707,400,307
2021-10-10,RA,17,PL34,54720,45888,8832,8832,0
2021-11-23,PW,26,PL37,812496,812208,3168,3168,0
2021-07-09,SD,13,PL19,64410,64388,52,0,52
2021-11-22,RT,21,PL06,207120,207312,288,288,0
2021-10-16,HO,18,PL01,64824,63768,1056,1056,0
2021-07-25,HO,18,PL32,66504,66416,88,88,0
2021-03-22,SD,13,PL17,70822,70501,909,528,381
2021-09-06,RT,21,PL05,208320,208416,48,48,0
2021-05-22,SB,11,PL50,426368,424768,2112,2112,0
2021-06-09,HO,18,PL33,132464,132464,0,0,0
2021-11-14,HO,18,PL10,68496,68488,96,96,0
2021-08-26,HO,18,PL09,72488,72528,88,88,0
2021-02-11,HO,18,PL03,65112,65088,120,120,0
2021-07-20,CL,14,PL44,302656,299104,1376,1376,0
2021-09-25,RA,17,PL35,230904,229488,1656,1656,0
2021-07-22,CL,14,PL44,291296,288800,2208,2208,0
2021-08-10,CL,14,PL44,293216,290912,2176,2176,0
2021-08-03,HO,18,PL03,64400,64320,152,152,0
2021-02-19,SB,11,PL36,306720,306408,1104,1104,0
2021-06-12,SD,13,PL21,76259,75707,744,192,552
2021-09-02,CH,24,PL08,190188,184951,6645,1408,5237
2021-03-04,CA,23,PL13,76280,76120,248,248,0
2021-06-03,PR,15,PL12,139392,139312,192,192,0
2021-02-18,HO,18,PL01,63312,62568,744,744,0
2021-09-17,SD,13,PL25,60367,59455,1916,880,1036
2021-03-20,CL,14,PL45,112608,98848,5824,5824,0
2021-10-31,SD,13,PL20,75930,75597,509,176,333
2021-02-01,RA,17,PL35,220824,221016,312,312,0
2021-08-31,CA,23,PL31,119184,118992,720,720,0
2021-01-20,CH,24,PL57,34232,34224,44,44,0
2021-12-12,RT,21,PL06,201120,201096,552,552,0
2021-07-29,HO,18,PL30,21600,21616,936,936,0
2021-03-07,RT,21,PL06,171720,168672,3048,3048,0
2021-07-11,PR,15,PL24,266816,266592,448,448,0
2021-02-14,CL,14,PL45,300352,291264,2144,2144,0
2021-01-10,CA,23,PL02,235968,234792,1392,1392,0
2021-06-15,PR,15,PL04,251936,245984,6560,6560,0
2021-11-27,HO,18,PL30,57744,53872,3872,3872,0
2021-03-30,SD,13,PL21,69939,69551,1440,1040,400
2021-10-22,HO,18,PL30,0,0,2160,2160,0
2021-08-22,CA,23,PL02,226800,226200,1152,1152,0
2021-05-31,SD,13,PL22,57929,56698,2719,1472,1247
2021-02-23,HO,18,PL33,61976,61088,936,936,0
2021-06-15,PB,25,PL55,444192,443936,832,832,0
2021-02-05,CH,24,PL08,270170,253760,24533,7872,16661
2021-03-14,PRG,12,PL14,368704,339104,29984,29984,0
2021-11-21,RA,17,PL34,31200,30384,816,816,0
2021-09-19,HO,18,PL09,66840,66664,176,176,0
2021-12-05,SD,13,PL20,68005,67464,939,384,555
2021-09-10,SB,11,PL36,309384,307968,1728,1728,0
2021-02-26,RT,21,PL05,172416,166944,5688,5688,0
2021-07-10,HO,18,PL01,67408,67320,88,88,0
2021-10-17,DI,19,PL53,298208,298368,0,0,0
2021-12-10,NT,16,PL51,328448,310912,17536,17536,0
2021-09-03,DI,19,PL52,290144,287648,2656,2656,0
2021-12-21,PR,15,PL24,263360,263488,384,384,0
2021-12-23,HO,18,PL11,4368,4240,128,128,0
2021-01-23,SD,13,PL25,31335,31199,854,576,278
2021-03-10,RT,21,PL05,177552,177312,240,240,0
2021-03-31,CA,23,PL31,227424,224448,3192,3192,0
2021-04-06,PB,25,PL54,2080,832,6016,6016,0
2021-01-05,SB,11,PL36,304872,303720,1536,1536,0
2021-07-20,PR,15,PL12,62544,59744,2864,2864,0
2021-01-13,PB,25,PL55,447072,443296,5376,5376,0
2021-08-01,SB,11,PL36,0,0,288,288,0
2021-06-26,CA,23,PL11,236832,236808,336,336,0
2021-02-16,HO,18,PL32,64456,64368,496,496,0
2021-10-27,RT,21,PL05,209760,208944,816,816,0
2021-08-28,HO,18,PL10,68208,68120,88,88,0
2021-11-28,DI,19,PL53,290624,288608,2432,2432,0
2021-11-15,RT,21,PL06,205128,204600,528,528,0
2021-02-26,CL,14,PL45,299488,282304,4928,4928,0
2021-02-11,SD,13,PL22,73228,73141,525,400,125
2021-09-09,SD,13,PL25,69489,68816,1361,672,689
2021-12-09,PR,15,PL24,209856,209504,352,352,0
2021-05-07,SB,11,PL50,200896,194784,10784,10784,0
2021-03-15,SD,13,PL22,71876,71700,944,768,176
2021-04-02,HO,18,PL09,71440,71352,88,88,0
2021-10-17,NT,16,PL51,510784,511040,1024,1024,0
2021-11-09,RA,17,PL35,191472,186504,8064,8064,0
2021-11-08,CL,14,PL44,301280,298880,1920,1920,0
2021-03-10,RT,21,PL06,196512,194688,1824,1824,0
2021-07-07,PB,25,PL54,330880,318240,13440,13440,0
2021-08-03,SD,13,PL19,61368,61313,55,0,55
2021-10-20,PR,15,PL04,243200,231136,18944,18944,0
2021-05-14,CA,23,PL31,225504,217200,8688,8688,0
2021-10-18,PR,15,PL04,261536,258368,3168,3168,0
2021-08-06,HO,18,PL03,66216,65760,456,456,0
2021-03-14,SD,13,PL19,73469,73067,1234,832,402
2021-04-17,PR,15,PL04,213504,213440,160,160,0
2021-03-27,CL,14,PL45,285632,279136,800,800,0
2021-09-10,SD,13,PL20,74830,74764,242,176,66
2021-02-10,RT,21,PL42,186176,184224,2816,2816,0
2021-09-04,PR,15,PL24,264192,264096,448,448,0
2021-01-31,HO,18,PL32,67984,66072,2008,2008,0
2021-02-03,HO,18,PL33,49096,49008,88,88,0
2021-09-04,SD,13,PL22,76234,76121,320,192,128
2021-08-24,CA,23,PL02,228432,228288,768,768,0
2021-01-09,SD,13,PL18,35505,34504,7876,6832,1044
2021-10-24,RT,21,PL05,209520,209304,456,456,0
2021-05-28,PW,26,PL37,808464,808560,3696,3696,0
2021-08-25,HO,18,PL10,68120,67816,336,336,0
2021-07-28,HO,18,PL40,48656,48008,688,688,0
2021-06-14,PB,25,PL54,285760,266400,20512,20512,0
2021-12-08,SD,13,PL17,61325,60505,1220,400,820
2021-02-18,CL,14,PL45,299200,287584,2624,2624,0
2021-03-10,HO,18,PL09,69720,69520,304,304,0
2021-04-19,CA,23,PL02,25224,25080,432,432,0
2021-05-18,PB,25,PL55,326560,314752,12384,12384,0
2021-01-11,NT,16,PL51,462368,459680,3008,3008,0
2021-02-04,RT,21,PL05,163968,163608,8088,8088,0
2021-09-30,CH,24,PL08,303792,296385,15439,8032,7407
2021-05-05,PB,25,PL54,8800,5536,12096,12096,0
2021-06-28,HO,18,PL10,53952,53472,480,480,0
2021-10-10,CH,24,PL12,132096,132000,192,192,0
2021-02-11,CA,23,PL13,85528,85424,184,184,0
2021-03-13,HO,18,PL11,65560,65496,104,104,0
2021-07-28,PR,15,PL12,138384,138368,176,176,0
2021-08-20,CH,24,PL12,90272,88752,2464,2464,0
2021-02-19,PR,15,PL24,193952,193632,1344,1344,0
2021-10-11,SB,11,PL50,330304,329856,2080,2080,0
2021-12-15,CA,23,PL13,84288,84128,432,432,0
2021-10-24,CA,23,PL13,85536,85544,88,88,0
2021-02-23,SD,13,PL18,74008,72875,1327,192,1135
2021-05-15,HO,18,PL32,64096,63704,392,392,0
2021-11-13,CH,24,PL24,162496,162240,464,464,0
2021-10-28,SB,11,PL50,462016,460544,2048,2048,0
2021-11-05,CA,23,PL02,148968,147792,2280,2280,0
2021-12-16,RA,17,PL34,249240,237120,12504,12504,0
2021-02-01,HO,18,PL01,65736,64744,992,992,0
2021-09-27,HO,18,PL03,61168,60912,304,304,0
2021-05-12,CL,14,PL44,212576,183520,2208,2208,0
2021-06-21,PB,25,PL54,59872,59456,5600,5600,0
2021-07-24,PB,25,PL54,22368,22368,39392,39392,0
2021-01-16,RA,17,PL35,220560,220224,336,336,0
2021-01-31,RA,17,PL35,222048,221592,456,456,0
2021-12-12,HO,18,PL11,66256,66256,0,0,0
2021-12-08,RA,17,PL34,167160,161952,5328,5328,0
2021-12-11,SD,13,PL25,65156,64571,953,368,585
2021-10-24,HO,18,PL01,67160,66248,912,912,0
2021-08-03,SD,13,PL25,46635,45969,666,0,666
2021-08-25,HO,18,PL01,67360,66144,1216,1216,0
2021-11-29,PRG,12,PL14,382720,381728,2048,2048,0
2021-07-31,EC,10,PL43,616752,615216,1488,1488,0
2021-05-30,HO,18,PL10,57072,56952,184,184,0
2021-03-02,HO,18,PL01,49864,46496,3496,3496,0
2021-06-06,SD,13,PL22,26356,26030,326,0,326
2021-09-24,HO,18,PL30,0,0,2096,2096,0
2021-09-06,SB,11,PL36,1320,984,336,336,0
2021-05-31,HO,18,PL32,67816,67728,88,88,0
2021-09-16,HO,18,PL33,131008,130880,192,192,0
2021-07-24,HO,18,PL33,15384,15312,120,120,0
2021-01-20,DI,19,PL53,298496,297216,1472,1472,0
2021-11-22,CL,14,PL45,292160,283584,3136,3136,0
2021-06-16,DI,19,PL52,287424,285376,2080,2080,0
2021-08-13,HO,18,PL56,37272,36824,4264,4264,0
2021-11-07,RT,21,PL06,196536,194712,2280,2280,0
2021-06-04,PB,25,PL54,302912,285152,17952,17952,0
2021-04-12,PR,15,PL24,262784,261952,1376,1376,0
2021-03-25,CL,14,PL44,301760,297184,480,480,0
2021-12-21,SD,13,PL18,46710,46021,1898,1088,810
2021-03-06,HO,18,PL11,66160,66016,144,144,0
2021-12-09,RT,21,PL42,0,0,0,0,0
2021-08-05,CH,24,PL57,34204,34124,104,104,0
2021-07-12,HO,18,PL10,68688,68600,88,88,0
2021-09-24,DI,19,PL52,175680,175264,512,512,0
2021-09-25,SD,13,PL19,75601,75434,359,192,167
2021-08-20,SD,13,PL25,75833,72394,4013,560,3453
2021-08-07,HO,18,PL30,66224,66208,0,0,0
2021-10-11,HO,18,PL03,65016,64840,176,176,0
2021-01-11,DI,19,PL52,295360,295424,992,992,0
2021-09-27,SD,13,PL19,68808,68609,871,672,199
2021-10-28,HO,18,PL30,1168,688,1024,1024,0
2021-07-07,RA,17,PL35,0,0,120,120,0
2021-11-03,HO,18,PL32,55760,55472,336,336,0
2021-11-12,EC,10,PL43,605136,604128,1536,1536,0
2021-07-01,SD,13,PL22,74338,73997,1877,1536,341
2021-11-29,HO,18,PL32,53256,53056,200,200,0
2021-05-06,HO,18,PL32,64232,64048,216,216,0
2021-06-02,HO,18,PL10,55712,55608,376,376,0
2021-06-02,PR,15,PL04,41984,41760,448,448,0
2021-04-09,RA,17,PL34,172248,169104,3696,3696,0
2021-11-02,SB,11,PL36,5424,3696,1728,1728,0
2021-01-22,PR,15,PL04,262176,259808,2336,2336,0
2021-09-21,CH,24,PL07,282659,277830,11997,7168,4829
2021-01-30,PR,15,PL24,263360,262720,1376,1376,0
2021-08-12,CH,24,PL08,250445,240228,13552,3232,10320
2021-12-19,RT,21,PL05,120096,119064,1104,1104,0
2021-04-13,NT,16,PL51,448128,447168,1568,1568,0
2021-07-23,HO,18,PL30,65664,65560,112,112,0
2021-01-12,SB,11,PL50,413952,409024,5888,5888,0
2021-04-29,HO,18,PL01,57632,57272,448,448,0
2021-10-14,HO,18,PL11,66200,65928,272,272,0
2021-01-18,PR,15,PL24,264064,263840,1024,1024,0
2021-05-11,PR,15,PL04,200960,198656,2432,2432,0
2021-07-28,PRG,12,PL14,388096,387680,1184,1184,0
2021-10-15,HO,18,PL32,0,0,256,256,0
2021-11-04,HO,18,PL11,64952,64616,336,336,0
2021-11-04,RT,21,PL06,204168,204240,264,264,0
2021-04-08,RT,21,PL05,207432,207168,264,264,0
2021-02-20,DI,19,PL52,276288,275584,1280,1280,0
2021-05-11,SD,13,PL19,70932,70899,1473,1440,33
2021-10-27,CL,14,PL45,229792,226112,4704,4704,0
2021-11-27,HO,18,PL10,68352,68392,144,144,0
2021-12-17,RT,21,PL05,123480,122688,1272,1272,0
2021-08-11,HO,18,PL03,66320,65992,440,440,0
2021-01-26,RA,17,PL34,122928,117888,14832,14832,0
2021-12-18,CH,24,PL08,261027,257908,13167,10048,3119
2021-05-14,RT,21,PL42,193696,193360,592,592,0
2021-02-02,SB,11,PL36,85416,84144,1272,1272,0
2021-11-05,HO,18,PL03,67600,67544,0,0,0
2021-09-10,SD,13,PL18,58314,58031,891,528,363
2021-06-11,SB,11,PL50,453888,452928,2272,2272,0
2021-07-15,SD,13,PL19,66008,65934,282,208,74
2021-04-29,SD,13,PL25,65929,65760,1066,896,170
2021-09-19,PB,25,PL55,445984,445088,1056,1056,0
2021-06-21,PR,15,PL04,257504,253504,4960,4960,0
2021-12-19,SD,13,PL18,38860,38126,1166,432,734
2021-11-12,DI,19,PL52,248992,248064,2464,2464,0
2021-01-23,CL,14,PL44,181568,176608,992,992,0
2021-08-01,HO,18,PL40,66208,66240,0,0,0
2021-10-26,CH,24,PL08,21408,19422,15618,13632,1986
2021-03-12,SB,11,PL36,314112,311568,2952,2952,0
2021-09-16,CA,23,PL31,124200,120672,4176,4176,0
2021-12-04,SD,13,PL22,75443,75349,270,176,94
2021-02-21,PRG,12,PL14,336928,325408,12128,12128,0
2021-10-08,PB,25,PL54,359008,338752,21984,21984,0
2021-04-06,SD,13,PL17,67851,67077,4032,3216,816
2021-01-15,DI,19,PL52,295680,295968,352,352,0
2021-03-25,HO,18,PL03,66224,66240,0,0,0
2021-06-10,PB,25,PL54,441024,439968,2208,2208,0
2021-10-01,EC,10,PL43,613680,613296,8784,8784,0
2021-03-08,CH,24,PL07,213129,206245,14091,6720,7371
2021-08-04,SD,13,PL17,74844,73758,1310,208,1102
2021-05-10,CH,24,PL08,275360,264706,17938,7168,10770
2021-07-30,PB,25,PL55,39456,36800,2656,2656,0
2021-09-05,SD,13,PL20,75281,75281,384,384,0
2021-07-01,CL,14,PL45,265024,255744,6976,6976,0
2021-10-30,HO,18,PL11,52792,52512,472,472,0
2021-04-10,SD,13,PL18,70106,69292,1016,176,840
2021-09-23,EC,10,PL43,610992,610080,1392,1392,0
2021-11-07,RT,21,PL05,166032,163392,2640,2640,0
2021-12-23,PB,25,PL55,95392,94560,1696,1696,0
2021-12-23,SD,13,PL19,6919,6825,286,192,94
2021-06-03,HO,18,PL32,67600,67288,312,312,0
2021-10-30,HO,18,PL01,52984,52184,848,848,0
2021-10-05,CL,14,PL44,298816,293312,2752,2752,0
2021-10-03,DI,19,PL53,294624,293024,1856,1856,0
2021-05-28,DI,19,PL53,294784,293824,1280,1280,0
2021-07-29,CL,14,PL45,283904,278144,3936,3936,0
2021-01-31,PW,26,PL37,814224,811056,3696,3696,0
2021-06-20,PB,25,PL55,439392,439104,1408,1408,0
2021-03-12,PR,15,PL24,263520,263040,800,800,0
2021-05-10,SD,13,PL19,75481,75485,994,944,50
2021-12-05,RT,21,PL06,180720,179640,1104,1104,0
2021-04-15,CA,23,PL13,83256,83064,368,368,0
2021-12-22,HO,18,PL11,65536,65440,104,104,0
2021-05-06,PRG,12,PL14,396032,395968,256,256,0
2021-08-14,SD,13,PL19,67120,67042,4846,4768,78
2021-11-08,CA,23,PL13,85192,85360,168,168,0
2021-09-03,SB,11,PL36,307944,305160,2928,2928,0
2021-08-09,PR,15,PL12,139136,139136,176,176,0
2021-09-10,CH,24,PL57,34064,34020,44,44,0
2021-10-22,CH,24,PL07,130854,125182,12328,6656,5672
2021-11-08,HO,18,PL32,43792,43376,416,416,0
2021-05-26,CH,24,PL57,20660,20684,0,0,0
2021-08-09,RT,21,PL42,134928,130096,4832,4832,0
2021-10-11,CH,24,PL08,310052,301660,11236,2560,8676
2021-12-10,HO,18,PL01,31120,30376,744,744,0
2021-03-30,PW,26,PL37,813504,811680,2832,2832,0
2021-10-30,CH,24,PL12,127472,126000,1552,1552,0
2021-04-15,PRG,12,PL14,396096,396256,320,320,0
2021-08-20,HO,18,PL10,68312,68264,120,120,0
2021-05-26,CA,23,PL02,228432,226896,1752,1752,0
2021-11-10,SD,13,PL19,76407,76310,352,176,176
2021-11-09,CH,24,PL24,162912,163200,288,288,0
2021-03-05,RA,17,PL35,219048,216864,2544,2544,0
2021-10-24,EC,10,PL43,565200,559008,6144,6144,0
2021-09-01,CL,14,PL45,207584,203136,2528,2528,0
2021-08-31,RT,21,PL06,133032,129480,3672,3672,0
2021-09-12,RT,21,PL42,109600,109056,864,864,0
2021-01-12,RT,21,PL05,203448,202464,1296,1296,0
2021-12-20,CA,23,PL35,69368,68216,1224,1224,0
2021-04-08,PR,15,PL57,138832,137040,1792,1792,0
2021-09-04,RA,17,PL34,179736,175392,4728,4728,0
2021-10-17,HO,18,PL09,66288,65744,544,544,0
2021-05-04,PW,26,PL37,469824,453504,16992,16992,0
2021-12-08,PB,25,PL55,426656,423808,4416,4416,0
2021-04-14,HO,18,PL09,54296,52880,1424,1424,0
2021-10-10,CL,14,PL45,277632,269408,6656,6656,0
2021-02-06,HO,18,PL10,57120,56784,336,336,0
2021-04-29,RT,21,PL42,192848,188576,4512,4512,0
2021-01-26,HO,18,PL30,66064,66096,0,0,0
2021-08-23,SD,13,PL17,0,0,0,0,0
2021-04-07,HO,18,PL32,55176,54032,1144,1144,0
2021-08-01,HO,18,PL10,25448,25344,104,104,0
2021-06-26,HO,18,PL30,65768,65752,96,96,0
2021-08-13,PR,15,PL24,265952,265280,672,672,0
2021-11-19,SD,13,PL20,65654,65556,1210,1088,122
2021-03-20,HO,18,PL32,54736,54640,96,96,0
2021-09-12,CA,23,PL13,83192,83160,88,88,0
2021-12-18,DI,19,PL53,293504,293152,512,512,0
2021-01-26,SD,13,PL19,51927,51726,1704,1456,248
2021-02-09,RT,21,PL06,196752,196848,0,0,0
2021-01-04,CA,23,PL13,84056,82816,1328,1328,0
2021-03-22,PRG,12,PL14,86016,81536,4480,4480,0
2021-09-20,SD,13,PL21,62423,61870,937,384,553
2021-07-15,SD,13,PL18,49330,49235,3627,3424,203
2021-08-24,SD,13,PL18,75997,75735,680,368,312
2021-12-17,CA,23,PL13,85456,85328,232,232,0
2021-05-12,HO,18,PL01,58576,58088,488,488,0
2021-08-10,HO,18,PL10,68056,68056,328,328,0
2021-08-17,HO,18,PL10,23664,23656,8,8,0
2021-10-29,SB,11,PL36,65952,65112,840,840,0
2021-05-07,PB,25,PL54,334080,271872,62368,62368,0
2021-08-09,RT,21,PL05,201768,201216,888,888,0
2021-02-03,RA,17,PL34,158592,158016,816,816,0
2021-05-09,PW,26,PL37,779376,776880,4656,4656,0
2021-02-23,NT,16,PL51,452128,447072,5824,5824,0
2021-05-02,HO,18,PL40,67464,67176,288,288,0
2021-04-28,PB,25,PL54,378912,366464,16864,16864,0
2021-06-24,HO,18,PL40,66248,66272,16,16,0
2021-03-06,PR,15,PL24,238208,234592,3840,3840,0
2021-06-03,PB,25,PL55,403488,386688,20448,20448,0
2021-11-13,PRG,12,PL12,328672,327328,1632,1632,0
2021-12-15,HO,18,PL09,3728,3728,0,0,0
2021-03-10,PR,15,PL04,189920,185888,5024,5024,0
2021-06-30,HO,18,PL03,67240,67072,168,168,0
2021-04-25,PB,25,PL55,449280,448640,1504,1504,0
2021-12-07,HO,18,PL03,66136,65864,264,264,0
2021-11-08,RT,21,PL41,16800,12128,4672,4672,0
2021-02-18,CA,23,PL13,78936,78560,464,464,0
2021-07-19,HO,18,PL32,67208,67208,96,96,0
2021-08-19,CH,24,PL07,274332,271426,8859,4320,4539
2021-06-21,CH,24,PL07,247149,231756,21665,6272,15393
2021-11-07,RA,17,PL35,263328,262296,1272,1272,0
2021-06-15,SD,13,PL18,67854,66392,3689,2128,1561
2021-10-23,CH,24,PL08,210453,201850,15872,7040,8832
2021-02-16,SD,13,PL21,72623,71918,950,192,758
2021-02-01,CA,23,PL31,149472,146568,3024,3024,0
2021-01-17,HO,18,PL03,66760,66704,128,128,0
2021-09-22,HO,18,PL40,66160,66160,0,0,0
2021-05-06,CH,24,PL08,309820,305597,7711,3136,4575
2021-01-05,HO,18,PL10,25320,22672,2832,2832,0
2021-08-09,HO,18,PL01,68288,68288,0,0,0
2021-05-17,HO,18,PL32,64784,64472,328,328,0
2021-09-30,HO,18,PL01,67872,66728,1144,1144,0
2021-06-27,HO,18,PL09,71952,71864,88,88,0
2021-02-07,SB,11,PL36,312576,312480,936,936,0
2021-08-21,CA,23,PL13,85264,85240,136,136,0
2021-10-03,PRG,12,PL14,389792,389760,1408,1408,0
2021-01-31,PR,15,PL57,137536,137328,368,368,0
2021-02-08,SB,11,PL36,312792,311280,1776,1776,0
2021-04-17,RT,21,PL05,165480,165312,264,264,0
2021-03-31,PR,15,PL04,252736,253216,288,288,0
2021-07-02,SD,13,PL18,35037,33448,3238,1632,1606
2021-02-01,CL,14,PL44,304480,297824,1376,1376,0
2021-05-16,RT,21,PL42,173712,172480,2048,2048,0
2021-05-07,HO,18,PL01,66120,65888,328,328,0
2021-11-17,HO,18,PL09,55480,55456,96,96,0
2021-04-14,CH,24,PL08,271671,260684,16587,5600,10987
2021-01-06,SD,13,PL18,69964,68531,1801,368,1433
2021-03-18,RA,17,PL34,220416,219960,600,600,0
2021-02-24,PW,26,PL37,529056,529104,1248,1248,0
2021-11-21,SB,11,PL36,306360,303888,2832,2832,0
2021-11-18,CH,24,PL07,37530,29556,10054,2080,7974
2021-01-11,RA,17,PL34,214464,211008,3672,3672,0
2021-05-12,DI,19,PL53,113472,111712,1760,1760,0
2021-05-09,SD,13,PL17,70545,70224,1203,880,323
2021-06-09,CH,24,PL57,33996,33904,224,224,0
2021-10-26,CA,23,PL02,181560,180624,1440,1440,0
2021-08-10,CL,14,PL45,234240,230016,3296,3296,0
2021-05-11,SB,11,PL36,295752,292536,3648,3648,0
2021-10-09,CL,14,PL44,274144,225056,22656,22656,0
2021-11-21,CA,23,PL31,231648,230184,1464,1464,0
2021-02-16,SD,13,PL20,41804,41573,615,384,231
2021-04-08,PR,15,PL24,262400,259776,3648,3648,0
2021-11-12,RT,21,PL06,206376,206016,360,360,0
2021-01-18,CA,23,PL31,1272,0,1272,1272,0
2021-05-24,HO,18,PL10,0,0,296,296,0
2021-01-28,CA,23,PL13,84976,85160,136,136,0
2021-04-14,RT,21,PL41,7488,6176,2560,2560,0
2021-05-02,CA,23,PL02,154200,154080,576,576,0
2021-09-01,CH,24,PL57,21264,21240,0,0,0
2021-01-08,SB,11,PL36,253968,245472,8616,8616,0
2021-01-25,PR,15,PL04,262560,252640,10464,10464,0
2021-11-02,NT,16,PL51,28032,27648,768,768,0
2021-03-31,PRG,12,PL14,380288,380032,960,960,0
2021-09-02,DI,19,PL53,218528,216224,3072,3072,0
2021-03-02,HO,18,PL32,29096,28912,304,304,0
2021-03-15,CA,23,PL13,76704,76672,296,296,0
2021-03-19,CA,23,PL31,214968,213144,2640,2640,0
2021-12-07,SD,13,PL20,75443,75013,1080,608,472
2021-01-26,PB,25,PL55,378624,311136,68480,68480,0
2021-03-11,NT,16,PL57,153616,153536,624,624,0
2021-01-26,SD,13,PL18,70958,70371,1007,400,607
2021-06-14,DI,19,PL53,173216,172448,1920,1920,0
2021-10-19,CA,23,PL02,231912,229800,2424,2424,0
2021-03-26,SD,13,PL17,47789,47393,780,384,396
2021-01-22,CA,23,PL02,231696,228240,3648,3648,0
2021-07-02,RT,21,PL41,5744,2272,3472,3472,0
2021-12-20,PR,15,PL24,264288,264064,416,416,0
2021-06-01,SD,13,PL18,56153,55914,5695,5456,239
2021-03-15,SD,13,PL19,72462,72063,2275,1760,515
2021-04-29,SD,13,PL18,40772,40556,13080,12864,216
2021-04-14,CL,14,PL45,225056,167840,14656,14656,0
2021-08-11,HO,18,PL01,67224,66440,784,784,0
2021-10-13,SD,13,PL20,76422,76205,410,192,218
2021-09-11,HO,18,PL56,63304,62736,608,608,0
2021-09-11,HO,18,PL40,62520,62536,280,280,0
2021-10-21,PB,25,PL55,439552,432768,7744,7744,0
2021-05-03,CA,23,PL11,233592,231648,2208,2208,0
2021-11-03,SB,11,PL50,294016,292640,1472,1472,0
2021-09-22,PR,15,PL24,270272,270016,256,256,0
2021-10-12,CH,24,PL12,153888,153504,640,640,0
2021-04-27,PR,15,PL24,249536,248672,960,960,0
2021-09-10,PR,15,PL04,114880,114496,1056,1056,0
2021-11-19,HO,18,PL33,41320,42832,216,216,0
2021-09-26,CH,24,PL08,291716,288761,14168,10688,3480
2021-10-24,SB,11,PL36,281184,279744,1536,1536,0
2021-02-05,SD,13,PL19,57803,57563,675,416,259
2021-09-05,NT,16,PL51,514784,514304,768,768,0
2021-04-16,NT,16,PL51,346464,345760,1504,1504,0
2021-01-16,PR,15,PL04,262656,261216,2048,2048,0
2021-08-17,CH,24,PL08,72148,66666,6698,1216,5482
2021-07-12,HO,18,PL30,64024,63232,840,840,0
2021-12-23,PB,25,PL54,97184,97024,160,160,0
2021-04-16,CL,14,PL45,251680,230432,5472,5472,0
2021-01-03,HO,18,PL01,66256,66248,0,0,0
2021-02-09,HO,18,PL10,52272,52056,216,216,0
2021-08-13,SD,13,PL17,71586,71416,632,448,184
2021-09-26,SD,13,PL21,63210,62887,915,592,323
2021-05-22,PW,26,PL37,755616,755568,2256,2256,0
2021-11-06,SD,13,PL17,67443,67306,587,432,155
2021-04-15,PR,15,PL24,263840,263456,1152,1152,0
2021-11-29,PB,25,PL55,445952,445536,4992,4992,0
2021-07-25,HO,18,PL30,62832,62904,0,0,0
2021-01-22,RA,17,PL56,218664,217704,1296,1296,0
2021-09-27,SD,13,PL25,74928,74300,804,176,628
2021-04-10,PW,26,PL37,811680,810096,4416,4416,0
2021-02-09,CL,14,PL44,214496,212000,544,544,0
2021-03-13,RT,21,PL42,123600,102864,21120,21120,0
2021-08-07,HO,18,PL11,66256,66256,0,0,0
2021-04-13,CL,14,PL44,218976,203680,9024,9024,0
2021-05-29,HO,18,PL40,65952,65600,352,352,0
2021-01-08,SB,11,PL50,188416,183712,4704,4704,0
2021-06-13,CA,23,PL11,233328,232536,936,936,0
2021-04-25,SB,11,PL36,312696,311688,1248,1248,0
2021-07-07,RT,21,PL41,14464,3760,10704,10704,0
2021-11-21,RT,21,PL06,208320,208320,96,96,0
2021-02-28,SD,13,PL17,74067,74026,462,368,94
2021-06-28,HO,18,PL40,42440,42080,680,680,0
2021-10-17,RT,21,PL05,209160,209136,288,288,0
2021-08-11,SD,13,PL25,64356,64008,1884,1536,348
2021-01-11,SD,13,PL18,55732,54536,1565,336,1229
2021-03-16,PB,25,PL55,168416,165408,3008,3008,0
2021-05-23,CH,24,PL07,306386,294188,14737,2432,12305
2021-02-01,HO,18,PL30,66152,66152,0,0,0
2021-10-15,CL,14,PL45,0,0,7520,7520,0
2021-12-01,SD,13,PL18,71435,70741,1096,400,696
2021-11-08,PB,25,PL54,435072,426624,8800,8800,0
2021-10-06,CA,23,PL13,85648,85672,88,88,0
2021-01-11,PR,15,PL04,264544,263936,608,608,0
2021-04-24,RA,17,PL35,221640,218832,2808,2808,0
2021-05-24,HO,18,PL30,30240,30024,248,248,0
2021-07-13,HO,18,PL01,63992,63384,608,608,0
2021-05-29,SD,13,PL19,76327,76292,211,176,35
2021-05-24,CA,23,PL31,206952,200544,6408,6408,0
2021-07-28,PW,26,PL37,190128,187488,26112,26112,0
2021-07-29,RT,21,PL42,153504,139184,14496,14496,0
2021-10-28,HO,18,PL56,56168,55864,304,304,0
2021-01-02,HO,18,PL30,48424,48368,56,56,0
2021-02-17,HO,18,PL10,54104,53920,184,184,0
2021-02-05,HO,18,PL33,66416,66072,344,344,0
2021-06-15,SD,13,PL25,75141,74053,1468,352,1116
2021-02-04,SD,13,PL20,72559,71474,2265,1120,1145
2021-04-09,HO,18,PL33,66088,66008,152,152,0
2021-01-27,CL,14,PL45,114560,98848,8384,8384,0
2021-02-16,SB,11,PL50,459872,458528,2144,2144,0
2021-12-03,SD,13,PL20,73483,72918,933,352,581
2021-10-04,PR,15,PL04,262016,260448,1824,1824,0
2021-01-25,RT,21,PL41,21632,21296,320,320,0
2021-05-21,CA,23,PL02,204792,196464,8568,8568,0
2021-07-27,SD,13,PL17,67210,66077,1781,592,1189
2021-07-03,SD,13,PL19,65212,65097,483,368,115
2021-12-18,PR,15,PL04,265376,264768,800,800,0
2021-02-05,RA,17,PL35,217488,216696,984,984,0
2021-02-06,SD,13,PL17,55896,54824,1758,400,1358
2021-06-06,CA,23,PL11,236328,235344,1272,1272,0
2021-06-13,SD,13,PL19,75797,75747,418,368,50
2021-12-02,SB,11,PL50,418816,376160,43392,43392,0
2021-06-14,PR,15,PL04,264128,262016,2432,2432,0
2021-11-08,SD,13,PL20,76406,76257,341,192,149
2021-03-08,DI,19,PL53,295520,295040,896,896,0
2021-05-22,CA,23,PL31,232752,231984,1152,1152,0
2021-09-28,SD,13,PL25,73231,72549,1260,480,780
2021-06-01,HO,18,PL01,61456,60816,640,640,0
2021-05-08,RT,21,PL42,191280,187200,4320,4320,0
2021-11-26,RA,17,PL56,0,0,5496,5496,0
2021-11-29,RT,21,PL05,158064,149280,8904,8904,0
2021-07-02,RT,21,PL05,208344,208512,0,0,0
2021-08-02,HO,18,PL10,65040,64856,224,224,0
2021-09-20,CA,23,PL02,211824,211512,1128,1128,0
2021-09-17,PW,26,PL37,802032,799056,5136,5136,0
2021-11-16,PR,15,PL04,267808,267840,128,128,0
2021-01-08,HO,18,PL11,61608,60720,944,944,0
2021-06-02,CL,14,PL44,189984,152096,5120,5120,0
2021-07-20,HO,18,PL40,65080,64728,432,432,0
2021-03-15,HO,18,PL33,31432,30104,1624,1624,0
2021-03-26,SD,13,PL18,24143,23281,1438,576,862
2021-08-15,HO,18,PL03,67592,67456,136,136,0
2021-05-02,DI,19,PL53,294176,293600,736,736,0
2021-06-07,SD,13,PL21,72274,71703,1032,416,616
2021-03-16,DI,19,PL52,295840,296160,448,448,0
2021-07-14,PB,25,PL55,161408,158080,13472,13472,0
2021-01-21,PR,15,PL24,267808,267168,800,800,0
2021-02-17,HO,18,PL11,66200,65976,272,272,0
2021-11-06,SB,11,PL50,451936,451040,2016,2016,0
2021-11-09,HO,18,PL30,2160,848,1312,1312,0
2021-06-02,CA,23,PL11,199488,197688,3648,3648,0
2021-10-21,CA,23,PL31,210888,207864,3408,3408,0
2021-03-16,SD,13,PL25,63518,63232,1518,1232,286
2021-01-29,HO,18,PL11,66264,66264,0,0,0
2021-01-20,RA,17,PL35,150120,140424,9840,9840,0
2021-03-17,PB,25,PL55,273312,272832,3232,3232,0
2021-06-16,PRG,12,PL14,393120,392544,800,800,0
2021-01-19,SD,13,PL18,39519,39428,1110,944,166
2021-04-12,PB,25,PL54,251552,231712,22368,22368,0
2021-10-29,HO,18,PL40,0,0,272,272,0
2021-03-01,SD,13,PL25,73129,73048,657,576,81
2021-04-19,SD,13,PL22,41576,41425,423,192,231
2021-02-26,HO,18,PL09,40104,39856,928,928,0
2021-05-05,CA,23,PL13,84032,84048,96,96,0
2021-02-24,CA,23,PL31,231720,228528,3288,3288,0
2021-01-18,HO,18,PL03,66736,66528,280,280,0
2021-09-19,SD,13,PL18,75037,74659,843,464,379
2021-09-24,HO,18,PL33,131264,131344,224,224,0
2021-06-09,HO,18,PL03,0,0,0,0,0
2021-01-30,SD,13,PL18,68114,67239,1291,416,875
2021-06-24,PR,15,PL12,136944,136816,208,208,0
2021-06-18,SD,13,PL22,61614,59885,2801,1072,1729
2021-07-07,CA,23,PL11,189816,185280,5472,5472,0
2021-09-30,HO,18,PL40,60752,60528,224,224,0
2021-05-14,HO,18,PL01,0,0,456,456,0
2021-06-14,RA,17,PL35,154560,154272,6744,6744,0
2021-02-08,SD,13,PL19,4965,4916,49,0,49
2021-01-24,SB,11,PL50,458624,458272,2304,2304,0
2021-12-09,SD,13,PL22,60275,60101,1907,1728,179
2021-07-20,PB,25,PL55,444512,438848,6592,6592,0
2021-09-09,HO,18,PL40,62504,61888,616,616,0
2021-01-28,HO,18,PL03,52200,51760,440,440,0
2021-11-29,PW,26,PL37,787200,787392,3312,3312,0
2021-09-02,SD,13,PL25,75061,73878,1404,176,1228
2021-01-07,PR,15,PL04,260928,245472,16064,16064,0
2021-07-13,SD,13,PL19,47769,47163,1246,640,606
2021-07-09,HO,18,PL10,68688,68592,104,104,0
2021-06-02,HO,18,PL30,66144,66240,0,0,0
2021-10-19,RA,17,PL34,259896,259056,1128,1128,0
2021-11-05,SD,13,PL22,0,0,661,624,37
2021-04-12,EC,10,PL43,621264,618912,2016,2016,0
2021-03-26,NT,16,PL57,34768,34656,0,0,0
2021-10-07,SD,13,PL22,75552,75514,484,432,52
2021-03-07,SD,13,PL25,73200,72947,797,544,253
2021-05-11,EC,10,PL43,180464,180320,176,176,0
2021-11-27,CH,24,PL08,298016,291136,7936,7936,0
2021-07-07,SD,13,PL19,66246,65561,1197,512,685
2021-10-19,SD,13,PL20,73264,73144,472,352,120
2021-02-24,SB,11,PL50,362528,360992,3264,3264,0
2021-02-19,HO,18,PL32,67840,67552,336,336,0
2021-01-19,DI,19,PL52,296832,296992,352,352,0
2021-11-08,HO,18,PL56,66048,65888,216,216,0
2021-11-22,PRG,12,PL14,388224,388384,1280,1280,0
2021-01-08,RA,17,PL56,219960,219768,264,264,0
2021-06-18,RT,21,PL05,204312,203640,1728,1728,0
2021-06-13,RA,17,PL34,214296,211176,3264,3264,0
2021-11-17,PRG,12,PL14,392960,391200,1760,1760,0
2021-02-08,RT,21,PL42,99232,51472,47760,47760,0
2021-07-24,SD,13,PL17,44639,43904,1250,480,770
2021-06-21,CA,23,PL11,230880,230256,1224,1224,0
2021-10-06,SD,13,PL22,72860,72883,257,176,81
2021-10-17,CA,23,PL13,85056,84944,120,120,0
2021-02-19,SD,13,PL19,59742,59690,2557,2464,93
2021-07-10,RT,21,PL42,187616,183952,3968,3968,0
2021-10-01,RT,21,PL41,114032,94432,19600,19600,0
2021-08-24,SD,13,PL19,72246,72258,591,528,63
2021-01-29,SB,11,PL36,313320,311736,2160,2160,0
2021-04-09,EC,10,PL43,605040,600240,5184,5184,0
2021-09-02,RT,21,PL05,201648,198984,2880,2880,0
2021-12-05,DI,19,PL53,291360,287616,4288,4288,0
2021-11-25,SD,13,PL18,18565,18360,7097,6864,233
2021-06-28,CL,14,PL45,297664,295328,1536,1536,0
2021-09-08,CL,14,PL45,232160,216448,6240,6240,0
2021-11-26,CH,24,PL12,106768,106192,576,576,0
2021-02-05,SB,11,PL50,449344,447968,2752,2752,0
2021-04-22,SD,13,PL19,68833,68746,1447,1360,87
2021-09-10,CH,24,PL12,165088,164592,720,720,0
2021-03-02,CA,23,PL13,50936,44976,6008,6008,0
2021-05-06,SB,11,PL36,295416,292800,2832,2832,0
2021-02-20,SD,13,PL18,67264,66359,2177,1248,929
2021-10-11,PR,15,PL24,265216,264768,448,448,0
2021-06-13,RT,21,PL42,147888,128448,19440,19440,0
2021-05-27,DI,19,PL53,294720,294688,384,384,0
2021-06-14,RT,21,PL42,115872,97872,18240,18240,0
2021-07-03,RT,21,PL05,204288,204432,432,432,0
2021-08-13,PB,25,PL55,165600,165856,1536,1536,0
2021-11-17,SD,13,PL21,64459,62404,2307,176,2131
2021-02-26,HO,18,PL33,68112,68000,192,192,0
2021-08-18,SD,13,PL19,0,0,0,0,0
2021-05-01,SD,13,PL17,72427,72050,984,560,424
2021-12-12,HO,18,PL33,68216,67312,920,920,0
2021-02-14,SD,13,PL25,72896,72850,262,192,70
2021-11-18,SD,13,PL19,76132,75991,506,352,154
2021-03-02,CH,24,PL04,163168,162768,640,640,0
2021-07-18,HO,18,PL10,68632,68560,112,112,0
2021-10-05,CA,23,PL31,90192,90480,24,24,0
2021-12-06,SD,13,PL21,66212,65782,622,192,430
2021-04-15,EC,10,PL43,318480,316512,1776,1776,0
2021-09-15,HO,18,PL32,56808,56704,104,104,0
2021-08-30,PRG,12,PL14,389248,388512,1632,1632,0
2021-12-27,SD,13,PL18,0,1411,169,0,169
2021-11-23,CH,24,PL24,132240,131072,1216,1216,0
2021-05-22,CH,24,PL12,153728,153184,640,640,0
2021-12-02,RT,21,PL42,137904,122896,15184,15184,0
2021-04-17,PB,25,PL54,343424,329120,16096,16096,0
2021-03-05,RT,21,PL06,184704,183192,1944,1944,0
2021-04-07,HO,18,PL01,66072,65744,328,328,0
2021-05-03,PB,25,PL54,450336,448544,2112,2112,0
2021-10-26,PR,15,PL04,214048,204640,9408,9408,0
2021-01-16,PB,25,PL55,446464,439360,9888,9888,0
2021-06-01,HO,18,PL10,56736,56568,184,184,0
2021-07-19,RA,17,PL34,0,0,96,96,0
2021-10-19,SB,11,PL50,35552,35552,0,0,0
2021-01-20,DI,19,PL52,283776,283872,1024,1024,0
2021-06-28,PR,15,PL04,249696,248256,1600,1600,0
2021-03-25,NT,16,PL51,469056,468032,1632,1632,0
2021-07-21,RT,21,PL42,182448,176944,5504,5504,0
2021-08-03,CH,24,PL57,33584,33376,208,208,0
2021-06-25,SB,11,PL36,255744,218184,37560,37560,0
2021-02-06,CH,24,PL07,165255,160832,6951,2528,4423
2021-02-02,RA,17,PL56,96,96,0,0,0
2021-08-16,SB,11,PL50,409856,393184,17536,17536,0
2021-09-08,SD,13,PL25,69121,68201,1177,192,985
2021-01-07,HO,18,PL10,22528,17992,4536,4536,0
2021-06-06,PR,15,PL04,264384,262176,2464,2464,0
2021-09-20,RT,21,PL06,205872,203712,2352,2352,0
2021-01-11,HO,18,PL33,67576,67512,96,96,0
2021-08-20,CA,23,PL13,60120,59992,192,192,0
2021-08-22,SD,13,PL19,74687,74700,235,176,59
2021-05-11,HO,18,PL33,66216,66216,0,0,0
2021-09-06,PRG,12,PL14,393728,392480,1248,1248,0
2021-09-14,SD,13,PL20,74406,74379,411,384,27
2021-10-20,RT,21,PL05,209808,209472,336,336,0
2021-02-25,CH,24,PL07,115909,113416,2909,416,2493
2021-12-12,PRG,12,PL14,391104,390784,864,864,0
2021-04-08,CL,14,PL44,272096,265088,4192,4192,0
2021-10-30,SD,13,PL22,57173,57050,1851,1728,123
2021-06-10,HO,18,PL09,71464,71400,88,88,0
2021-07-07,PR,15,PL12,93568,93536,240,240,0
2021-09-27,HO,18,PL40,64560,64448,112,112,0
2021-06-14,SD,13,PL25,74016,73157,1051,176,875
2021-12-10,SD,13,PL17,51435,50667,1366,560,806
2021-07-03,DI,19,PL53,288864,287552,1888,1888,0
2021-08-19,SD,13,PL25,22690,22579,3269,2768,501
2021-10-08,HO,18,PL01,67544,66944,600,600,0
2021-11-10,RT,21,PL42,125952,82064,43888,43888,0
2021-12-19,CA,23,PL35,79152,79176,96,96,0
2021-02-18,SD,13,PL18,74041,72999,1234,192,1042
2021-05-10,HO,18,PL09,72224,72256,104,104,0
2021-06-13,HO,18,PL10,56920,56888,128,128,0
2021-07-21,SD,13,PL17,71379,69886,1690,176,1514
2021-10-05,HO,18,PL09,66576,66624,184,184,0
2021-10-08,HO,18,PL11,65568,65288,320,320,0
2021-09-22,SD,13,PL25,69897,69389,1023,512,511
2021-10-18,SB,11,PL50,453536,450752,3136,3136,0
2021-03-29,PRG,12,PL14,293536,292608,2496,2496,0
2021-04-05,CH,24,PL07,282074,270557,16080,2848,13232
2021-10-25,CA,23,PL31,218472,215424,3048,3048,0
2021-09-01,HO,18,PL40,49048,48584,520,520,0
2021-04-15,CA,23,PL02,172512,172440,1104,1104,0
2021-06-23,RA,17,PL35,146232,140952,5328,5328,0
2021-06-21,DI,19,PL52,292192,291872,928,928,0
2021-10-12,CL,14,PL44,297760,288352,3552,3552,0
2021-10-17,CL,14,PL45,0,0,1056,1056,0
2021-12-10,PRG,12,PL14,392416,392704,992,992,0
2021-02-21,HO,18,PL11,64536,64200,376,376,0
2021-04-03,HO,18,PL11,41776,40952,824,824,0
2021-03-14,CH,24,PL08,294569,285917,17777,9120,8657
2021-05-28,CA,23,PL13,71624,71392,360,360,0
2021-05-15,HO,18,PL01,0,0,112,112,0
2021-06-18,HO,18,PL32,67920,67848,96,96,0
2021-11-12,CA,23,PL31,190200,187224,2976,2976,0
2021-05-16,CA,23,PL31,165864,165072,1728,1728,0
2021-12-18,CA,23,PL31,235440,234840,840,840,0
2021-01-06,CA,23,PL31,141744,141144,600,600,0
2021-03-11,RA,17,PL56,13104,8064,5088,5088,0
2021-05-20,HO,18,PL40,68528,68528,0,0,0
2021-10-21,SD,13,PL25,75825,75060,941,176,765
2021-02-12,PB,25,PL55,436064,431904,4576,4576,0
2021-01-26,SD,13,PL20,50143,50048,321,224,97
2021-05-27,CA,23,PL13,84384,84304,240,240,0
2021-12-18,SD,13,PL19,72849,72706,564,384,180
2021-12-13,RT,21,PL06,207168,207000,288,288,0
2021-08-19,CA,23,PL31,0,0,2904,2904,0
2021-02-03,CA,23,PL02,171288,170640,1656,1656,0
2021-10-05,SB,11,PL36,281184,279864,1896,1896,0
2021-11-14,SB,11,PL50,456064,455328,1728,1728,0
2021-11-09,HO,18,PL32,33408,33128,368,368,0
2021-01-14,HO,18,PL03,65368,65128,336,336,0
2021-11-14,RT,21,PL41,165216,150528,14720,14720,0
2021-10-18,RT,21,PL06,196584,195576,1440,1440,0
2021-07-05,RT,21,PL05,201888,202008,408,408,0
2021-08-04,PR,15,PL24,264224,263776,1152,1152,0
2021-10-27,HO,18,PL33,132480,132480,0,0,0
2021-08-13,RT,21,PL42,182608,174176,8720,8720,0
2021-07-05,HO,18,PL30,65184,65088,96,96,0
2021-08-20,SD,13,PL19,73600,73286,570,176,394
2021-04-09,PR,15,PL24,267616,266496,1376,1376,0
2021-05-30,SD,13,PL22,57203,56116,1800,656,1144
2021-11-27,PR,15,PL04,263136,263136,448,448,0
2021-01-09,RT,21,PL05,201408,200208,1488,1488,0
2021-03-29,SD,13,PL20,75711,75534,833,640,193
2021-04-22,HO,18,PL01,7352,7240,112,112,0
2021-01-18,PRG,12,PL14,391648,390848,1056,1056,0
2021-03-12,CA,23,PL13,85408,85264,224,224,0
2021-02-12,PR,15,PL24,264736,264256,768,768,0
2021-07-21,RA,17,PL34,213456,212664,1032,1032,0
2021-05-06,CA,23,PL02,0,0,2544,2544,0
2021-05-14,HO,18,PL30,13856,13920,0,0,0
2021-05-30,DI,19,PL53,295680,294624,1056,1056,0
2021-11-18,DI,19,PL52,221600,219616,2496,2496,0
2021-09-25,HO,18,PL10,68552,68272,328,328,0
2021-09-27,PB,25,PL55,129472,96960,32512,32512,0
2021-05-31,RT,21,PL06,180240,179952,6480,6480,0
2021-04-10,RT,21,PL05,206160,206424,264,264,0
2021-02-11,RT,21,PL06,206832,206808,288,288,0
2021-10-04,EC,10,PL43,619872,619344,624,624,0
2021-07-21,HO,18,PL09,51208,50872,336,336,0
2021-11-20,RT,21,PL42,119568,74704,44864,44864,0
2021-07-02,PR,15,PL24,262752,262176,960,960,0
2021-08-24,RT,21,PL06,0,0,0,0,0
2021-09-26,CA,23,PL13,84512,84240,424,424,0
2021-12-16,SD,13,PL17,34930,34259,847,176,671
2021-05-05,NT,16,PL51,60768,58592,2176,2176,0
2021-05-17,RA,17,PL35,191232,190992,288,288,0
2021-02-12,CH,24,PL04,164592,164400,192,192,0
2021-07-13,PR,15,PL12,137376,137392,368,368,0
2021-05-15,SB,11,PL50,425792,424416,6240,6240,0
2021-12-17,CA,23,PL31,230040,229536,792,792,0
2021-06-12,SD,13,PL25,73804,72564,1475,176,1299
2021-06-16,SD,13,PL21,69714,69104,997,384,613
2021-09-28,CH,24,PL57,34224,34180,44,44,0
2021-06-30,PB,25,PL55,451808,444192,8352,8352,0
2021-03-26,HO,18,PL01,42336,41784,552,552,0
2021-03-09,PW,26,PL37,799344,795360,5952,5952,0
2021-12-02,HO,18,PL01,60328,59680,680,680,0
2021-02-03,PRG,12,PL12,26272,0,26272,26272,0
2021-07-14,HO,18,PL03,61240,60896,344,344,0
2021-12-22,SD,13,PL21,74908,74281,803,176,627
2021-06-24,RT,21,PL06,199896,198216,1776,1776,0
2021-10-15,RT,21,PL41,179072,172096,7136,7136,0
2021-05-11,HO,18,PL30,66224,66224,0,0,0
2021-10-02,HO,18,PL03,66864,66816,136,136,0
2021-12-11,PW,26,PL37,747312,737040,10800,10800,0
2021-12-13,DI,19,PL53,130880,129056,2016,2016,0
2021-02-26,SD,13,PL21,73034,72585,641,192,449
2021-06-26,PW,26,PL37,817968,817824,2496,2496,0
2021-11-01,SD,13,PL19,63152,63008,721,544,177
2021-02-12,HO,18,PL32,67016,67064,152,152,0
2021-06-16,HO,18,PL01,66216,66184,88,88,0
2021-10-13,CL,14,PL44,304352,299776,1088,1088,0
2021-01-21,HO,18,PL10,54880,54752,280,280,0
2021-03-17,CA,23,PL13,84928,84904,88,88,0
2021-12-02,HO,18,PL32,38336,38304,88,88,0
2021-05-13,RT,21,PL42,184416,160928,23488,23488,0
2021-05-10,HO,18,PL30,64792,64512,344,344,0
2021-11-25,SD,13,PL22,76023,75938,645,560,85
2021-11-01,SD,13,PL21,64620,64483,489,352,137
2021-04-19,PR,15,PL04,146496,146208,672,672,0
2021-12-13,HO,18,PL11,42424,42360,72,72,0
2021-09-03,CH,24,PL08,109964,99540,16600,6176,10424
2021-02-01,RT,21,PL41,16032,10016,6080,6080,0
2021-05-25,SD,13,PL25,0,0,0,0,0
2021-04-08,SD,13,PL21,72341,72077,486,192,294
2021-06-21,HO,18,PL09,72184,72160,88,88,0
2021-08-06,SD,13,PL17,70932,69072,2257,384,1873
2021-10-06,CH,24,PL08,219790,216101,7369,3680,3689
2021-02-28,CH,24,PL12,112288,109696,2848,2848,0
2021-05-30,SD,13,PL21,73501,73221,493,208,285
2021-05-02,SD,13,PL25,70393,70277,660,544,116
2021-02-17,SD,13,PL22,70748,70579,619,448,171
2021-06-29,RT,21,PL06,205176,204960,312,312,0
2021-09-21,RT,21,PL06,195384,194424,1104,1104,0
2021-04-22,SD,13,PL22,66878,65866,1668,656,1012
2021-11-29,SD,13,PL19,55454,55308,562,352,210
2021-02-16,HO,18,PL10,55960,55888,88,88,0
2021-01-28,RA,17,PL35,221256,221016,576,576,0
2021-01-11,SD,13,PL17,72702,72523,168,0,168
2021-01-16,HO,18,PL33,67824,67736,88,88,0
2021-09-15,RT,21,PL05,114984,114912,288,288,0
2021-01-25,PRG,12,PL12,385568,384128,1632,1632,0
2021-02-02,SD,13,PL22,71721,71682,858,720,138
2021-04-23,PB,25,PL54,76480,76736,21600,21600,0
2021-06-12,CH,24,PL57,34148,34092,56,56,0
2021-08-10,PRG,12,PL14,389920,389728,1184,1184,0
2021-11-17,HO,18,PL40,66032,65952,264,264,0
2021-07-31,CL,14,PL45,277984,275040,2208,2208,0
2021-08-06,RT,21,PL05,203616,203640,576,576,0
2021-09-14,CA,23,PL13,85504,85472,96,96,0
2021-03-14,CL,14,PL44,298912,294656,1152,1152,0
2021-03-26,RT,21,PL41,0,0,0,0,0
2021-11-30,PW,26,PL37,812592,812592,1680,1680,0
2021-02-22,SB,11,PL50,447840,445280,4864,4864,0
2021-08-08,SB,11,PL36,304656,302544,2112,2112,0
2021-11-05,NT,16,PL51,510144,509440,1600,1600,0
2021-01-06,SB,11,PL36,277800,276816,9432,9432,0
2021-02-01,RA,17,PL34,216600,213048,3552,3552,0
2021-08-21,PR,15,PL24,266048,264608,1440,1440,0
2021-09-21,CA,23,PL02,232776,232992,456,456,0
2021-01-30,NT,16,PL51,444320,430688,14400,14400,0
2021-08-06,SD,13,PL20,51762,51724,543,448,95
2021-06-01,RA,17,PL35,212304,210600,2112,2112,0
2021-09-06,RT,21,PL41,64352,62800,1552,1552,0
2021-10-06,PB,25,PL54,277408,261536,15872,15872,0
2021-03-03,PW,26,PL37,0,0,5616,5616,0
2021-08-16,CL,14,PL44,9664,9664,7936,7936,0
2021-02-01,HO,18,PL10,57056,56960,136,136,0
2021-04-17,NT,16,PL51,373952,373024,1472,1472,0
2021-09-03,CA,23,PL13,62960,63016,200,200,0
2021-04-25,HO,18,PL03,66288,66096,192,192,0
2021-07-09,RT,21,PL05,205392,205488,264,264,0
2021-10-04,DI,19,PL52,284096,283712,896,896,0
2021-08-23,SD,13,PL25,44610,43792,2800,960,1840
2021-04-30,PR,15,PL57,138784,138384,400,400,0
2021-09-29,RT,21,PL05,203160,203232,336,336,0
2021-05-01,DI,19,PL52,285408,283904,1504,1504,0
2021-06-04,DI,19,PL52,294208,294048,512,512,0
2021-09-06,RA,17,PL35,231768,231216,552,552,0
2021-02-06,SD,13,PL22,72548,72404,599,368,231
2021-01-18,SD,13,PL18,61809,61619,1278,1088,190
2021-09-09,RT,21,PL42,178960,177504,1840,1840,0
2021-02-24,DI,19,PL53,297856,296608,1888,1888,0
2021-03-20,CH,24,PL12,148592,147888,784,784,0
2021-07-03,CA,23,PL31,157152,153120,4248,4248,0
2021-10-22,PB,25,PL54,438848,434208,5920,5920,0
2021-12-21,RT,21,PL41,113952,65472,48800,48800,0
2021-01-12,CH,24,PL08,269727,259112,18538,7904,10634
2021-01-06,SD,13,PL20,67158,66516,1104,448,656
2021-03-08,PB,25,PL55,290592,290208,832,832,0
2021-03-29,RT,21,PL06,204504,204024,696,696,0
2021-05-01,EC,10,PL43,160064,159904,288,288,0
2021-03-02,CA,23,PL31,206712,195984,10992,10992,0
2021-04-30,SD,13,PL21,73274,72833,1033,592,441
2021-05-17,RT,21,PL41,0,0,0,0,0
2021-03-16,PW,26,PL37,682752,675552,8832,8832,0
2021-08-07,RT,21,PL05,208752,208752,0,0,0
2021-08-29,SD,13,PL18,70409,69885,1280,736,544
2021-12-11,PRG,12,PL14,387776,387584,864,864,0
2021-09-14,RA,17,PL35,167544,164760,4680,4680,0
2021-03-13,SB,11,PL50,454464,453376,1952,1952,0
2021-06-25,SD,13,PL20,73919,73810,477,368,109
2021-07-29,HO,18,PL32,54832,54704,128,128,0
2021-09-17,SD,13,PL21,42871,42479,392,0,392
2021-05-14,CA,23,PL02,206760,205800,1584,1584,0
2021-04-16,RA,17,PL56,108744,100128,9120,9120,0
2021-04-26,SD,13,PL20,76002,75868,369,176,193
2021-09-11,HO,18,PL11,66320,66320,0,0,0
2021-04-21,CA,23,PL11,140592,138240,2352,2352,0
2021-06-25,SD,13,PL19,70012,70038,623,560,63
2021-06-07,CH,24,PL08,220169,199513,40720,16288,24432
2021-01-08,HO,18,PL03,65536,64672,864,864,0
2021-02-20,NT,16,PL51,465856,464320,2304,2304,0
2021-03-03,RA,17,PL35,211128,210072,1704,1704,0
2021-06-17,PRG,12,PL14,392704,392480,832,832,0
2021-02-02,HO,18,PL01,64640,64424,376,376,0
2021-06-19,HO,18,PL40,66240,66048,192,192,0
2021-08-22,CH,24,PL08,149077,127894,23998,2720,21278
2021-06-23,HO,18,PL10,55136,53224,1912,1912,0
2021-08-16,RT,21,PL06,0,0,0,0,0
2021-06-10,SD,13,PL25,70515,69524,1393,384,1009
2021-06-18,CA,23,PL31,231000,226608,4728,4728,0
2021-06-30,SD,13,PL22,66667,65990,2383,1760,623
2021-03-28,NT,16,PL51,464320,462848,1824,1824,0
2021-06-18,PB,25,PL54,430784,425408,5408,5408,0
2021-05-12,SD,13,PL22,60048,59832,696,480,216
2021-07-28,RA,17,PL34,219312,218664,648,648,0
2021-06-17,RA,17,PL34,217560,216144,1512,1512,0
2021-03-23,HO,18,PL32,67696,67480,232,232,0
2021-10-08,HO,18,PL03,67616,67616,0,0,0
2021-11-03,HO,18,PL09,68544,68536,0,0,0
2021-08-08,SD,13,PL18,48906,48253,3197,2544,653
2021-08-03,HO,18,PL01,66648,66184,464,464,0
2021-10-09,DI,19,PL52,256704,257120,0,0,0
2021-11-30,HO,18,PL03,65504,63216,2288,2288,0
2021-01-04,RT,21,PL05,205824,205104,1032,1032,0
2021-02-18,RA,17,PL56,218808,217872,1104,1104,0
2021-04-27,RT,21,PL41,0,0,0,0,0
2021-09-14,PR,15,PL24,265312,263872,1600,1600,0
2021-03-15,CH,24,PL12,111712,111568,400,400,0
2021-09-01,PRG,12,PL14,391744,391552,1216,1216,0
2021-03-04,CH,24,PL12,96256,95792,3120,3120,0
2021-06-04,SD,13,PL25,46417,46094,3251,2928,323
2021-02-10,HO,18,PL03,66136,65824,312,312,0
2021-09-16,HO,18,PL32,57640,57640,0,0,0
2021-06-12,HO,18,PL10,44416,44264,264,264,0
2021-06-19,EC,10,PL43,616128,613488,4896,4896,0
2021-02-01,SD,13,PL22,71461,71345,308,192,116
2021-07-07,SD,13,PL20,71571,71512,1275,1216,59
2021-02-19,HO,18,PL10,50768,50008,768,768,0
2021-02-12,CH,24,PL08,199040,184480,14784,14784,0
2021-03-29,SB,11,PL50,451936,448512,4576,4576,0
2021-05-18,HO,18,PL40,65608,65024,584,584,0
2021-11-05,CH,24,PL57,34200,34176,44,44,0
2021-05-28,CA,23,PL02,224616,224064,1032,1032,0
2021-06-18,SD,13,PL25,75299,74340,959,0,959
2021-11-10,SD,13,PL20,76118,75915,419,192,227
2021-12-11,DI,19,PL53,152960,152832,128,128,0
2021-04-17,HO,18,PL10,29688,29552,264,264,0
2021-06-13,SB,11,PL50,459712,459744,1536,1536,0
2021-06-22,HO,18,PL01,67024,65856,1232,1232,0
2021-01-09,NT,16,PL51,455872,448576,9248,9248,0
2021-04-27,PR,15,PL04,251040,250656,896,896,0
2021-04-19,HO,18,PL11,37432,37432,0,0,0
2021-06-08,SD,13,PL20,0,0,384,384,0
2021-10-14,SD,13,PL25,76564,75822,1060,304,756
2021-11-03,RA,17,PL35,238920,237456,1464,1464,0
2021-06-27,HO,18,PL01,63456,63176,280,280,0
2021-09-07,HO,18,PL10,68464,68392,88,88,0
2021-09-27,CH,24,PL12,161920,161440,480,480,0
2021-01-16,HO,18,PL03,67048,66912,152,152,0
2021-01-24,RA,17,PL56,180264,176016,4344,4344,0
2021-02-27,HO,18,PL32,65432,65264,168,168,0
2021-03-09,SD,13,PL21,43089,42480,7894,7248,646
2021-05-11,SD,13,PL17,70993,70588,1012,576,436
2021-06-07,HO,18,PL09,71440,71352,96,96,0
2021-10-27,CL,14,PL44,298432,294784,3584,3584,0
2021-09-26,SD,13,PL25,76500,76125,642,176,466
2021-10-12,RA,17,PL34,213072,207288,5784,5784,0
2021-03-01,SD,13,PL17,72705,72600,730,624,106
2021-06-16,DI,19,PL53,270368,267616,3072,3072,0
2021-05-02,SD,13,PL21,68630,67986,878,224,654
2021-10-28,HO,18,PL33,132240,132176,128,128,0
2021-10-15,RT,21,PL42,144,0,144,144,0
2021-09-22,HO,18,PL56,66120,65896,224,224,0
2021-09-22,EC,10,PL43,621600,621984,576,576,0
2021-02-07,CL,14,PL45,300192,290432,2240,2240,0
2021-04-26,HO,18,PL33,66072,65824,248,248,0
2021-07-03,PR,15,PL04,261952,261408,896,896,0
2021-11-14,CL,14,PL45,282144,273856,6080,6080,0
2021-01-14,SD,13,PL17,70633,70515,819,688,131
2021-11-11,DI,19,PL52,289312,287872,2240,2240,0
2021-05-27,CH,24,PL57,17476,17436,280,280,0
2021-06-28,SB,11,PL36,298488,295464,3336,3336,0
2021-05-21,HO,18,PL09,68272,67656,808,808,0
2021-09-06,CA,23,PL02,187032,186480,1464,1464,0
2021-11-03,SD,13,PL17,69188,69101,487,368,119
2021-05-12,CH,24,PL57,32264,32224,40,40,0
2021-10-10,RT,21,PL06,168456,168624,48,48,0
2021-02-02,PR,15,PL24,260288,255936,4768,4768,0
2021-10-06,RT,21,PL42,107168,63680,43824,43824,0
2021-01-17,SD,13,PL20,71496,71404,707,560,147
2021-08-25,SD,13,PL19,53648,53533,707,592,115
2021-02-19,CH,24,PL07,270562,263336,12868,5600,7268
2021-02-09,PW,26,PL37,766368,765456,1968,1968,0
2021-01-25,DI,19,PL53,285088,282848,2240,2240,0
2021-11-21,HO,18,PL11,63032,62240,792,792,0
2021-01-16,PR,15,PL24,263456,258656,4928,4928,0
2021-11-05,SD,13,PL20,76122,76051,309,176,133
2021-06-13,CH,24,PL57,34124,34080,44,44,0
2021-02-01,HO,18,PL09,69104,68848,328,328,0
2021-06-09,CA,23,PL02,238296,238032,408,408,0
2021-05-25,SD,13,PL21,62796,62433,3291,2928,363
2021-01-20,CH,24,PL08,286530,269913,22185,5568,16617
2021-11-06,HO,18,PL10,68296,68264,104,104,0
2021-01-11,HO,18,PL10,56712,56632,112,112,0
2021-01-17,RA,17,PL56,221760,221016,744,744,0
2021-03-04,HO,18,PL01,66128,65952,216,216,0
2021-03-19,RA,17,PL34,222840,223056,0,0,0
2021-07-25,HO,18,PL33,65816,65496,320,320,0
2021-09-22,RA,17,PL35,230112,228192,2256,2256,0
2021-03-24,PR,15,PL04,262976,263264,544,544,0
2021-11-21,EC,10,PL43,620016,619776,1152,1152,0
2021-10-08,EC,10,PL43,452112,429840,20688,20688,0
2021-12-13,HO,18,PL32,11488,11352,136,136,0
2021-04-08,CH,24,PL07,229226,209218,27912,7904,20008
2021-04-23,PB,25,PL55,221408,220928,1088,1088,0
2021-08-27,CH,24,PL12,42384,41296,1088,1088,0
2021-10-26,SD,13,PL25,75010,74370,1388,624,764
2021-06-01,HO,18,PL09,71888,71760,128,128,0
2021-02-24,RA,17,PL34,219408,218976,888,888,0
2021-03-26,CH,24,PL12,104496,104496,192,192,0
2021-07-14,EC,10,PL43,625680,623760,1920,1920,0
2021-10-14,HO,18,PL03,66944,66848,96,96,0
2021-07-22,HO,18,PL32,66568,66456,208,208,0
2021-01-29,CH,24,PL07,271302,256690,23444,8832,14612
2021-10-13,SB,11,PL36,185208,182208,3000,3000,0
2021-01-10,HO,18,PL30,62984,62960,160,160,0
2021-06-07,PR,15,PL24,264352,264032,864,864,0
2021-06-19,PB,25,PL54,378432,376384,2592,2592,0
2021-02-07,SD,13,PL21,73564,72848,908,192,716
2021-06-09,RA,17,PL35,188184,183192,4992,4992,0
2021-10-17,HO,18,PL33,132512,132512,0,0,0
2021-10-02,HO,18,PL11,53664,53408,256,256,0
2021-10-23,CA,23,PL13,85648,85632,88,88,0
2021-08-17,CL,14,PL45,96064,91072,2144,2144,0
2021-05-15,SB,11,PL36,215928,213120,3288,3288,0
2021-06-18,PW,26,PL37,811968,810432,3120,3120,0
2021-03-25,SD,13,PL19,60908,60351,2122,1552,570
2021-06-07,RA,17,PL34,220608,220128,552,552,0
2021-10-12,CH,24,PL57,33248,33188,104,104,0
2021-03-31,DI,19,PL52,109920,109920,0,0,0
2021-01-27,SD,13,PL19,52135,51940,2227,2032,195
2021-04-02,HO,18,PL33,66224,66224,0,0,0
2021-06-11,RA,17,PL35,224688,223920,840,840,0
2021-08-28,SD,13,PL25,75032,74657,727,352,375
2021-02-15,SD,13,PL19,66890,66208,1754,1072,682
2021-05-15,PB,25,PL54,406816,399872,9088,9088,0
2021-03-28,CA,23,PL31,228336,227496,1440,1440,0
2021-11-05,HO,18,PL40,66184,65976,208,208,0
2021-11-23,RA,17,PL34,252264,250440,2112,2112,0
2021-08-06,CH,24,PL07,177752,167217,15639,5088,10551
2021-07-05,HO,18,PL09,70936,70272,664,664,0
2021-11-29,RA,17,PL34,239592,238368,1224,1224,0
2021-09-11,RA,17,PL34,214368,212376,2472,2472,0
2021-10-07,HO,18,PL33,131168,130864,304,304,0
2021-09-13,CA,23,PL31,159072,159024,360,360,0
2021-04-25,RT,21,PL05,207864,207600,264,264,0
2021-05-25,SD,13,PL17,55093,53716,5809,4432,1377
2021-02-26,SD,13,PL20,66000,65698,1022,720,302
2021-01-29,RA,17,PL34,217560,215400,2160,2160,0
2021-01-04,CH,24,PL57,33972,33984,72,72,0
2021-06-08,RT,21,PL41,22368,12928,9440,9440,0
2021-06-13,SD,13,PL18,48847,47622,3305,2080,1225
2021-05-25,PRG,12,PL14,371616,367200,4416,4416,0
2021-10-29,PB,25,PL55,138304,127680,10624,10624,0
2021-08-11,SD,13,PL22,73408,73366,362,320,42
2021-05-05,CH,24,PL08,311484,308574,6270,3360,2910
2021-09-15,CL,14,PL44,303552,299520,3392,3392,0
2021-11-13,CA,23,PL13,85352,85296,184,184,0
2021-02-06,RT,21,PL05,207264,207216,432,432,0
2021-01-03,RT,21,PL05,184080,181560,2952,2952,0
2021-02-21,RT,21,PL05,209064,209184,24,24,0
2021-03-07,HO,18,PL32,65264,64328,936,936,0
2021-01-13,SD,13,PL21,67600,65933,2371,704,1667
2021-12-14,DI,19,PL52,203584,202624,1216,1216,0
2021-08-13,CH,24,PL07,279656,267102,17542,4000,13542
2021-03-26,SD,13,PL19,43386,42761,3332,2720,612
2021-03-17,RT,21,PL06,136680,135432,9960,9960,0
2021-08-02,SD,13,PL17,69184,68147,1677,640,1037
2021-09-10,CA,23,PL02,34344,30144,4200,4200,0
2021-09-15,PB,25,PL55,188704,135872,80992,80992,0
2021-04-21,HO,18,PL01,63008,62832,304,304,0
2021-08-27,SD,13,PL21,72329,72364,1223,1200,23
2021-05-20,RA,17,PL35,141336,141216,888,888,0
2021-04-26,HO,18,PL09,69576,68960,608,608,0
2021-05-20,CL,14,PL45,278432,275040,2464,2464,0
2021-05-18,PR,15,PL04,7552,7136,1248,1248,0
2021-09-14,CA,23,PL31,176736,175872,1776,1776,0
2021-04-07,PR,15,PL57,143248,143248,176,176,0
2021-06-01,RA,17,PL56,10752,10752,0,0,0
2021-10-29,HO,18,PL33,41776,41776,0,0,0
2021-02-19,SD,13,PL20,60645,60382,1431,1168,263
2021-09-11,CA,23,PL02,193392,193176,288,288,0
2021-12-12,CA,23,PL35,77320,77160,184,184,0
2021-03-10,RT,21,PL42,186064,182256,3952,3952,0
2021-02-03,RT,21,PL05,209664,208680,1104,1104,0
2021-06-20,RT,21,PL06,205752,203856,1896,1896,0
2021-11-29,PRG,12,PL54,0,0,4064,4064,0
2021-11-30,HO,18,PL33,67216,66936,728,728,0
2021-12-03,CH,24,PL57,30908,30828,88,88,0
2021-08-17,PB,25,PL55,149344,148704,1056,1056,0
2021-05-01,PB,25,PL55,444256,440576,4192,4192,0
2021-09-08,HO,18,PL10,69248,69248,0,0,0
2021-10-27,PB,25,PL55,446336,446496,1536,1536,0
2021-11-08,SD,13,PL19,30892,29432,1636,176,1460
2021-12-04,PR,15,PL24,0,0,2624,2624,0
2021-10-20,DI,19,PL52,0,0,11584,11584,0
2021-08-07,HO,18,PL03,66816,66728,88,88,0
2021-09-27,CH,24,PL08,306261,303847,8501,5728,2773
2021-01-24,HO,18,PL30,66160,66160,0,0,0
2021-02-17,SD,13,PL17,73165,73059,282,176,106
2021-12-21,PB,25,PL54,437344,432320,5024,5024,0
2021-02-21,SB,11,PL36,309888,308352,1872,1872,0
2021-03-19,RT,21,PL42,119792,117696,3120,3120,0
2021-11-21,HO,18,PL10,67768,67880,104,104,0
2021-06-09,HO,18,PL40,66224,65808,416,416,0
2021-11-06,PRG,12,PL12,384992,383424,2272,2272,0
2021-02-09,HO,18,PL09,47272,49088,1368,1368,0
2021-03-05,HO,18,PL11,66280,66272,8,8,0
2021-06-27,DI,19,PL52,288736,288064,672,672,0
2021-01-02,HO,18,PL01,44488,44384,192,192,0
2021-10-19,NT,16,PL51,506432,502880,3648,3648,0
2021-12-04,RA,17,PL34,255408,252912,2760,2760,0
2021-08-21,CH,24,PL12,10112,9344,768,768,0
2021-12-12,CA,23,PL31,232032,230448,1752,1752,0
2021-10-14,HO,18,PL56,66016,65808,304,304,0
2021-01-16,RA,17,PL56,218520,217776,936,936,0
2021-07-14,HO,18,PL32,65080,65072,136,136,0
2021-09-19,PRG,12,PL14,389472,388096,2144,2144,0
2021-05-15,SD,13,PL18,60102,59578,2956,2432,524
2021-11-08,HO,18,PL09,64688,64688,160,160,0
2021-12-09,HO,18,PL32,55128,54920,208,208,0
2021-06-27,SD,13,PL20,44824,44756,1012,944,68
2021-03-19,RT,21,PL05,202512,202248,480,480,0
2021-03-29,SD,13,PL21,72933,72684,1255,896,359
2021-02-03,RA,17,PL35,106848,103680,3288,3288,0
2021-09-28,CH,24,PL07,224281,222243,5368,3328,2040
2021-10-05,HO,18,PL11,65080,64880,256,256,0
2021-07-30,HO,18,PL56,35128,35120,1168,1168,0
2021-08-04,CH,24,PL08,247770,233495,16381,2080,14301
2021-02-15,PRG,12,PL14,324992,315808,9184,9184,0
2021-07-05,DI,19,PL52,61760,61344,416,416,0
2021-02-23,DI,19,PL52,212640,212448,416,416,0
2021-03-18,CH,24,PL07,316948,309337,9034,1312,7722
2021-03-19,SD,13,PL20,42249,42016,1753,1520,233
2021-10-05,PR,15,PL24,260896,260000,1504,1504,0
2021-03-25,SB,11,PL50,453504,452224,1856,1856,0
2021-07-01,PR,15,PL12,138256,137872,496,496,0
2021-07-16,SD,13,PL18,72054,71317,1729,992,737
2021-11-27,CH,24,PL12,116608,116432,480,480,0
2021-10-13,HO,18,PL33,129968,129760,336,336,0
2021-09-25,SD,13,PL18,75777,74867,1102,192,910
2021-10-25,PRG,12,PL14,393376,392800,928,928,0
2021-09-28,SD,13,PL21,64763,64409,546,192,354
2021-06-21,NT,16,PL51,405152,402880,4288,4288,0
2021-01-24,HO,18,PL33,67632,67432,200,200,0
2021-08-14,PR,15,PL24,264064,263232,1248,1248,0
2021-02-25,RT,21,PL42,184128,182416,2048,2048,0
2021-02-19,RA,17,PL56,220800,220536,264,264,0
2021-06-02,RA,17,PL34,120648,119424,2256,2256,0
2021-09-30,SD,13,PL22,69902,69837,512,416,96
2021-05-29,SD,13,PL17,75472,74955,943,352,591
2021-10-28,RT,21,PL05,181608,176856,4992,4992,0
2021-12-16,RT,21,PL42,138048,135456,2592,2592,0
2021-10-15,CA,23,PL13,85128,84976,120,120,0
2021-06-06,SD,13,PL20,76458,75117,1516,176,1340
2021-02-22,PRG,12,PL12,361280,361024,672,672,0
2021-01-03,SB,11,PL36,300696,299472,1848,1848,0
2021-05-02,CA,23,PL13,77528,76552,1136,1136,0
2021-03-02,RA,17,PL35,166320,164112,4200,4200,0
2021-03-25,RT,21,PL42,174544,163152,11568,11568,0
2021-04-26,SD,13,PL22,75111,74492,795,176,619
2021-11-20,CA,23,PL31,207912,205632,2808,2808,0
2021-07-02,SD,13,PL19,67592,67530,606,544,62
2021-03-31,SD,13,PL20,66328,65977,1104,752,352
2021-01-08,DI,19,PL52,295648,295072,1120,1120,0
2021-09-26,NT,16,PL51,514528,514304,672,672,0
2021-10-27,SD,13,PL19,76221,76075,339,192,147
2021-04-26,CA,23,PL02,234936,234480,456,456,0
2021-09-20,NT,16,PL51,514272,514560,1120,1120,0
2021-12-23,DI,19,PL53,7520,7456,0,0,0
2021-02-01,CH,24,PL08,292021,271501,28660,8128,20532
2021-09-02,SD,13,PL19,70436,70374,2910,2848,62
2021-06-27,PR,15,PL24,268256,268256,0,0,0
2021-11-28,CH,24,PL57,33516,33436,92,92,0
2021-03-04,SD,13,PL22,72284,72153,323,192,131
2021-05-16,CH,24,PL08,203455,194752,23911,12384,11527
2021-02-16,CH,24,PL07,279916,271285,12951,4320,8631
2021-03-31,HO,18,PL01,65512,65264,248,248,0
2021-06-06,CA,23,PL02,229488,228360,1296,1296,0
2021-04-10,RA,17,PL56,221424,217920,3816,3816,0
2021-09-06,DI,19,PL53,265920,266080,3328,3328,0
2021-01-16,CA,23,PL02,229896,228720,1896,1896,0
2021-04-10,HO,18,PL33,65704,65592,112,112,0
2021-02-03,PRG,12,PL14,338688,327200,12032,12032,0
2021-11-01,SD,13,PL25,71236,70134,1368,176,1192
2021-04-12,HO,18,PL10,57680,57688,0,0,0
2021-07-05,RT,21,PL41,384,0,384,384,0
2021-11-04,HO,18,PL09,65408,65112,296,296,0
2021-11-28,NT,16,PL51,469568,462592,7648,7648,0
2021-01-10,SD,13,PL25,69388,69172,600,384,216
2021-04-07,CL,14,PL44,91840,52992,7808,7808,0
2021-05-11,HO,18,PL32,66824,66472,424,424,0
2021-05-29,RT,21,PL05,205080,204816,528,528,0
2021-04-22,PRG,12,PL14,391744,391904,672,672,0
2021-05-10,HO,18,PL10,57688,57600,88,88,0
2021-08-24,CH,24,PL07,299268,296273,12369,9216,3153
2021-02-22,EC,10,PL43,620880,619152,1680,1680,0
2021-08-10,PR,15,PL12,139232,139232,208,208,0
2021-02-13,SB,11,PL50,458400,457696,1216,1216,0
2021-05-16,PRG,12,PL14,354784,353632,2336,2336,0
2021-07-14,SD,13,PL25,0,0,2974,2848,126
2021-12-02,DI,19,PL53,101696,100928,768,768,0
2021-01-28,SB,11,PL36,310344,309384,1560,1560,0
2021-12-21,SD,13,PL19,69611,69439,545,368,177
2021-02-18,CH,24,PL07,126308,119694,8118,1504,6614
2021-05-18,PRG,12,PL14,390752,390336,1088,1088,0
2021-06-29,RA,17,PL35,214344,212832,1656,1656,0
2021-12-03,PW,26,PL37,765312,761952,5184,5184,0
2021-01-25,RA,17,PL56,174432,174264,1176,1176,0
2021-02-09,RT,21,PL42,98448,90544,8992,8992,0
2021-06-06,CH,24,PL08,200214,188174,22227,8928,13299
2021-01-17,HO,18,PL30,64912,64832,152,152,0
2021-01-25,RA,17,PL35,211488,210288,1200,1200,0
2021-06-04,CL,14,PL44,294880,286688,7232,7232,0
2021-10-20,CA,23,PL13,51880,51640,872,872,0
2021-09-25,EC,10,PL43,622800,622032,528,528,0
2021-01-26,SB,11,PL50,445664,440192,5792,5792,0
2021-05-07,RA,17,PL35,224016,223824,864,864,0
2021-02-16,RA,17,PL34,162264,161784,1272,1272,0
2021-02-25,CA,23,PL31,234024,233280,936,936,0
2021-10-13,SB,11,PL50,401408,400096,7392,7392,0
2021-02-28,SD,13,PL25,66007,65597,1242,832,410
2021-04-25,CA,23,PL31,222408,220560,1848,1848,0
2021-01-23,CH,24,PL08,150724,125243,34729,9248,25481
2021-06-17,RA,17,PL35,216168,214080,7152,7152,0
2021-10-08,SD,13,PL22,67472,67520,1002,960,42
2021-11-07,HO,18,PL09,67528,67328,208,208,0
2021-03-14,HO,18,PL03,66136,66160,0,0,0
2021-04-21,RT,21,PL05,209736,209856,72,72,0
2021-05-09,HO,18,PL03,60352,60352,0,0,0
2021-09-22,SD,13,PL20,50800,50060,1277,528,749
2021-07-30,EC,10,PL43,635280,632400,2592,2592,0
2021-09-21,SD,13,PL17,62965,62526,1170,688,482
2021-01-24,HO,18,PL11,66288,66288,0,0,0
2021-11-27,CH,24,PL57,33532,33556,52,52,0
2021-02-06,RT,21,PL06,209904,209880,48,48,0
2021-02-26,HO,18,PL11,46256,45912,344,344,0
2021-11-14,CH,24,PL24,126672,123392,3280,3280,0
2021-03-13,PRG,12,PL14,371104,356288,14816,14816,0
2021-08-07,HO,18,PL33,23656,23616,472,472,0
2021-09-14,HO,18,PL10,68296,68208,168,168,0
2021-10-27,SD,13,PL22,67291,67213,1015,912,103
2021-06-24,SD,13,PL25,71764,69818,2378,432,1946
2021-01-05,SB,11,PL50,91136,90336,2776,2776,0
2021-06-15,SD,13,PL19,54962,54884,448,368,80
2021-05-31,CL,14,PL44,298688,294432,3840,3840,0
2021-04-28,SD,13,PL19,72455,72408,1999,1952,47
2021-10-22,CA,23,PL02,235848,235728,672,672,0
2021-10-29,SD,13,PL19,13676,13386,1122,832,290
2021-02-05,HO,18,PL01,66104,65512,592,592,0
2021-11-10,CA,23,PL31,214584,206880,8208,8208,0
2021-10-20,CL,14,PL45,289472,281216,7744,7744,0
2021-03-28,HO,18,PL33,63976,63816,160,160,0
2021-12-23,SD,13,PL17,320,320,0,0,0
2021-04-25,CH,24,PL07,253837,246981,13472,6336,7136
2021-09-22,DI,19,PL52,204864,203584,3520,3520,0
2021-05-18,CA,23,PL02,225912,217320,9312,9312,0
2021-07-27,SD,13,PL19,59254,59142,758,624,134
2021-06-05,HO,18,PL32,64072,63968,344,344,0
2021-11-09,CH,24,PL57,34048,34044,60,60,0
2021-07-16,CA,23,PL11,0,0,144,144,0
2021-10-02,CH,24,PL07,254368,245097,21785,12160,9625
2021-03-20,HO,18,PL11,58728,58560,168,168,0
2021-09-22,HO,18,PL10,69224,69224,0,0,0
2021-06-05,HO,18,PL30,66224,66224,0,0,0
2021-10-10,PB,25,PL55,70304,63456,6848,6848,0
2021-01-27,PRG,12,PL12,394976,394496,800,800,0
2021-03-30,DI,19,PL53,298784,299136,0,0,0
2021-08-22,SD,13,PL18,70158,69104,1445,368,1077
2021-02-25,HO,18,PL01,66008,65360,648,648,0
2021-01-19,SB,11,PL50,326816,317728,10752,10752,0
2021-01-10,HO,18,PL01,63296,62704,592,592,0
2021-09-29,CL,14,PL45,78400,59904,10464,10464,0
2021-05-21,NT,16,PL51,439040,428736,10752,10752,0
2021-09-03,HO,18,PL56,48184,48104,80,80,0
2021-03-24,RT,21,PL05,177264,177336,2352,2352,0
2021-03-20,DI,19,PL52,269312,265536,3968,3968,0
2021-05-08,HO,18,PL33,66064,65888,176,176,0
2021-05-20,HO,18,PL32,67408,67400,232,232,0
2021-11-29,HO,18,PL03,39456,39368,728,728,0
2021-01-24,SB,11,PL36,299856,298656,1944,1944,0
2021-05-17,SD,13,PL22,55014,54380,1502,368,1134
2021-04-10,RA,17,PL35,106392,105288,1080,1080,0
2021-05-02,NT,16,PL51,469536,469440,384,384,0
2021-01-08,PB,25,PL55,446368,445024,3712,3712,0
2021-03-03,RT,21,PL42,185520,181648,4032,4032,0
2021-03-06,PRG,12,PL14,285472,231520,54016,54016,0
2021-03-18,SB,11,PL50,1600,0,1600,1600,0
2021-01-07,CA,23,PL31,223128,221136,2832,2832,0
2021-10-25,SD,13,PL20,75338,75203,542,384,158
2021-04-27,CA,23,PL02,212400,210480,2088,2088,0
2021-09-11,HO,18,PL03,66720,66632,88,88,0
2021-10-30,HO,18,PL09,51792,51600,240,240,0
2021-09-16,CL,14,PL44,227200,223328,3776,3776,0
2021-03-19,SD,13,PL21,61947,61425,714,192,522
2021-05-24,CA,23,PL13,0,0,0,0,0
2021-03-03,PR,15,PL24,264352,264192,512,512,0
2021-08-07,SB,11,PL50,10976,9824,1152,1152,0
2021-08-03,SD,13,PL17,74373,73307,1534,384,1150
2021-09-13,CL,14,PL44,298656,295072,3712,3712,0
2021-09-04,HO,18,PL09,72040,71840,200,200,0
2021-08-25,HO,18,PL11,64032,63560,472,472,0
2021-05-17,PRG,12,PL14,388672,388544,896,896,0
2021-05-11,CA,23,PL11,154104,146280,9648,9648,0
2021-05-22,RA,17,PL34,206952,206712,264,264,0
2021-09-20,HO,18,PL10,68288,68240,96,96,0
2021-01-24,RT,21,PL06,190488,190200,432,432,0
2021-10-05,PR,15,PL04,263584,261536,2368,2368,0
2021-05-29,HO,18,PL33,132272,132432,0,0,0
2021-05-18,SD,13,PL25,70087,69788,1163,864,299
2021-03-01,CH,24,PL08,208864,203768,13384,8288,5096
2021-07-28,RT,21,PL05,204696,204456,576,576,0
2021-05-03,RA,17,PL35,222960,222672,1080,1080,0
2021-04-14,SD,13,PL19,72497,72480,437,384,53
2021-08-29,CA,23,PL31,161376,161160,504,504,0
2021-04-25,PR,15,PL57,140320,140224,176,176,0
2021-08-10,HO,18,PL09,69632,69352,304,304,0
2021-03-19,EC,10,PL43,386112,349824,39696,39696,0
2021-05-31,SD,13,PL19,75275,75227,416,352,64
2021-06-24,PW,26,PL37,798288,797376,3360,3360,0
2021-10-19,HO,18,PL03,64992,64832,184,184,0
2021-06-11,HO,18,PL01,67368,67400,96,96,0
2021-07-08,HO,18,PL40,58656,58024,632,632,0
2021-09-04,DI,19,PL52,293664,292096,1568,1568,0
2021-12-22,CA,23,PL02,203112,202704,432,432,0
2021-06-16,PW,26,PL37,698208,693168,6192,6192,0
2021-03-31,CH,24,PL08,301578,295650,10521,4256,6265
2021-11-04,PRG,12,PL14,391296,390976,1024,1024,0
2021-01-14,SD,13,PL21,66882,65955,1162,208,954
2021-01-03,SD,13,PL25,70479,70189,658,368,290
2021-09-21,SD,13,PL21,65529,65055,666,192,474
2021-01-05,PRG,12,PL14,382464,380416,2656,2656,0
2021-03-05,SD,13,PL17,73757,73590,206,16,190
2021-06-29,PRG,12,PL14,391968,391328,896,896,0
2021-01-08,SD,13,PL18,68940,67246,2173,416,1757
2021-01-11,SB,11,PL50,445248,441984,3264,3264,0
2021-05-21,SD,13,PL25,62867,62563,3024,2720,304
2021-02-07,SD,13,PL20,68448,67038,2182,768,1414
2021-05-08,SD,13,PL21,68477,67986,2830,2288,542
2021-09-18,HO,18,PL11,64504,64280,360,360,0
2021-03-21,CA,23,PL31,234168,234000,504,504,0
2021-10-08,SD,13,PL21,65885,65633,620,368,252
2021-02-05,DI,19,PL52,290304,286304,4352,4352,0
2021-06-24,PB,25,PL55,447072,443840,5344,5344,0
2021-05-12,HO,18,PL03,42120,41384,736,736,0
2021-07-16,PRG,12,PL14,389792,389344,1920,1920,0
2021-10-20,SD,13,PL25,75771,74867,1515,544,971
2021-06-15,HO,18,PL30,64376,64360,224,224,0
2021-11-29,CH,24,PL57,32764,32664,100,100,0
2021-06-08,HO,18,PL40,61656,61728,432,432,0
2021-01-18,PW,26,PL37,378480,274992,103488,103488,0
2021-12-20,PR,15,PL04,265024,264544,832,832,0
2021-03-20,CH,24,PL08,251873,241559,16563,5888,10675
2021-06-08,SD,13,PL19,68041,68345,687,400,287
2021-10-30,RA,17,PL35,232560,227592,5736,5736,0
2021-10-24,SB,11,PL50,400544,397728,4320,4320,0
2021-11-03,SD,13,PL20,74978,74877,544,400,144
2021-08-03,CH,24,PL08,302219,297475,9414,4544,4870
2021-03-11,SB,11,PL36,306456,304200,2424,2424,0
2021-07-11,CH,24,PL08,303700,298850,9456,4448,5008
2021-05-12,PW,26,PL37,566544,562512,4512,4512,0
2021-10-21,CH,24,PL57,32996,32880,120,120,0
2021-02-28,HO,18,PL10,51712,50208,1504,1504,0
2021-01-12,CH,24,PL57,34228,34216,48,48,0
2021-01-26,HO,18,PL09,69712,69640,176,176,0
2021-11-12,SD,13,PL22,3892,3864,4211,4192,19
2021-05-22,HO,18,PL03,66768,66608,232,232,0
2021-09-23,CA,23,PL02,214176,214152,312,312,0
2021-01-11,CA,23,PL31,75144,74136,1512,1512,0
2021-02-08,PRG,12,PL12,392608,391360,1568,1568,0
2021-05-02,PR,15,PL04,267360,267744,0,0,0
2021-09-01,RA,17,PL35,147168,146616,552,552,0
2021-02-24,RT,21,PL42,186208,176496,9952,9952,0
2021-05-06,SB,11,PL50,457248,455680,1824,1824,0
2021-06-26,HO,18,PL01,67712,67616,96,96,0
2021-05-05,HO,18,PL01,41224,40696,672,672,0
2021-10-24,HO,18,PL09,67624,67368,256,256,0
2021-09-14,HO,18,PL01,66256,65352,1144,1144,0
2021-10-26,CH,24,PL12,164256,162960,1296,1296,0
2021-12-22,PW,26,PL37,433968,423408,11616,11616,0
2021-03-08,SD,13,PL21,68381,67875,681,176,505
2021-08-07,RA,17,PL34,224328,223992,336,336,0
2021-03-24,HO,18,PL32,68088,67936,160,160,0
2021-06-20,HO,18,PL03,65840,65840,104,104,0
2021-06-09,NT,16,PL51,441984,434688,7968,7968,0
2021-04-17,SD,13,PL25,26225,26147,2799,2720,79
2021-10-06,SD,13,PL21,66379,66109,633,352,281
2021-05-16,HO,18,PL30,57736,57576,160,160,0
2021-10-19,HO,18,PL56,65160,64704,456,456,0
2021-09-15,RA,17,PL34,37848,37848,0,0,0
2021-01-02,HO,18,PL10,0,0,64,64,0
2021-09-12,HO,18,PL11,65480,65352,152,152,0
2021-09-03,RT,21,PL42,64656,58384,6400,6400,0
2021-02-15,NT,16,PL51,471072,470496,736,736,0
2021-03-25,PW,26,PL37,805776,804000,4560,4560,0
2021-08-06,PR,15,PL24,260960,260928,544,544,0
2021-12-08,CH,24,PL08,173425,169284,6029,1888,4141
2021-10-31,HO,18,PL11,66144,65192,952,952,0
2021-12-11,CH,24,PL12,164624,164352,272,272,0
2021-08-27,HO,18,PL10,69104,68816,288,288,0
2021-05-18,HO,18,PL03,66272,66104,200,200,0
2021-01-15,RT,21,PL05,161472,160536,936,936,0
2021-09-18,CA,23,PL02,208776,207336,1440,1440,0
2021-02-19,RT,21,PL05,172320,172152,792,792,0
2021-05-10,RA,17,PL34,165312,163488,2136,2136,0
2021-05-11,CH,24,PL57,34340,34292,48,48,0
2021-07-17,RT,21,PL05,204504,203784,888,888,0
2021-10-18,PRG,12,PL14,388544,386976,2944,2944,0
2021-02-22,PR,15,PL24,158432,157536,1248,1248,0
2021-09-28,CA,23,PL13,53120,52944,320,320,0
2021-02-08,CH,24,PL04,163632,163024,656,656,0
2021-01-25,CH,24,PL57,34204,34160,44,44,0
2021-03-02,CL,14,PL45,245856,216448,14848,14848,0
2021-10-17,CA,23,PL02,231264,230928,744,744,0
2021-03-17,DI,19,PL53,293536,292576,1728,1728,0
2021-06-29,SB,11,PL50,332896,327488,5984,5984,0
2021-06-03,HO,18,PL03,67600,67600,0,0,0
2021-04-09,SD,13,PL22,75092,75022,263,176,87
2021-11-10,SD,13,PL25,72331,70368,2259,192,2067
2021-03-25,HO,18,PL33,65368,65200,168,168,0
2021-08-12,SD,13,PL18,75109,74710,575,176,399
2021-02-08,RT,21,PL05,201168,198768,2520,2520,0
2021-09-24,CH,24,PL57,33776,33712,92,92,0
2021-12-02,PW,26,PL37,811680,812736,1776,1776,0
2021-11-27,EC,10,PL43,574848,574080,1152,1152,0
2021-04-11,PB,25,PL54,391104,362400,29280,29280,0
2021-01-20,PR,15,PL24,265408,264704,800,800,0
2021-04-13,PR,15,PL57,140304,138624,1952,1952,0
2021-08-15,CL,14,PL44,288128,282208,4992,4992,0
2021-09-20,RA,17,PL34,0,0,312,312,0
2021-04-17,SD,13,PL17,53597,52140,2018,544,1474
2021-11-04,CA,23,PL13,85520,85456,96,96,0
2021-03-24,DI,19,PL52,297056,296832,352,352,0
2021-09-12,SD,13,PL22,71984,71932,1860,1808,52
2021-10-11,NT,16,PL51,505952,503424,3040,3040,0
2021-11-17,DI,19,PL53,0,0,0,0,0
2021-01-12,RT,21,PL42,0,0,5712,5712,0
2021-11-17,DI,19,PL52,230496,229344,1312,1312,0
2021-07-27,PB,25,PL54,224352,211168,13408,13408,0
2021-05-04,SD,13,PL25,70995,70868,538,384,154
2021-12-22,RT,21,PL06,168672,168384,1272,1272,0
2021-01-08,HO,18,PL30,66160,66160,0,0,0
2021-04-07,HO,18,PL11,66288,66288,0,0,0
2021-09-23,HO,18,PL01,67400,66704,768,768,0
2021-09-18,HO,18,PL56,65824,64864,960,960,0
2021-05-09,HO,18,PL40,67480,66720,760,760,0
2021-07-28,EC,10,PL43,521328,509712,11136,11136,0
2021-05-05,HO,18,PL30,65128,64856,216,216,0
2021-09-24,HO,18,PL09,67496,67152,400,400,0
2021-09-16,HO,18,PL40,66288,66240,48,48,0
2021-10-02,CA,23,PL13,85248,85272,224,224,0
2021-04-26,SD,13,PL19,69331,69219,866,752,114
2021-02-08,CA,23,PL13,84720,84744,200,200,0
2021-06-28,CA,23,PL31,230832,230088,1272,1272,0
2021-07-27,PR,15,PL12,138704,138592,320,320,0
2021-11-27,SD,13,PL18,56056,55020,1420,384,1036
2021-05-16,RA,17,PL56,201888,202104,0,0,0
2021-06-17,SD,13,PL19,57014,56977,947,880,67
2021-02-21,SD,13,PL25,73761,73740,440,400,40
2021-07-06,EC,10,PL43,614640,613104,2448,2448,0
2021-11-28,CA,23,PL31,196896,195792,1416,1416,0
2021-02-04,SD,13,PL21,70544,68874,1905,192,1713
2021-08-11,HO,18,PL11,65256,65216,176,176,0
2021-09-28,PB,25,PL54,0,0,0,0,0
2021-07-02,NT,16,PL51,462336,461216,10112,10112,0
2021-05-12,PRG,12,PL14,369280,369024,1056,1056,0
2021-05-29,CA,23,PL13,85056,85080,128,128,0
2021-07-06,HO,18,PL40,66264,66320,16,16,0
2021-10-02,HO,18,PL32,57576,57536,64,64,0
2021-06-07,RA,17,PL56,220488,219792,912,912,0
2021-08-08,PR,15,PL24,264928,264800,480,480,0
2021-02-26,CA,23,PL31,225600,224064,1896,1896,0
2021-06-11,EC,10,PL43,613728,611904,2400,2400,0
2021-04-30,HO,18,PL40,68008,67912,96,96,0
2021-11-21,SB,11,PL50,454400,453760,1536,1536,0
2021-10-26,PRG,12,PL14,390240,389696,960,960,0
2021-07-20,RA,17,PL34,200664,199224,1632,1632,0
2021-09-09,SB,11,PL50,461504,460672,1184,1184,0
2021-03-25,DI,19,PL53,274336,274560,928,928,0
2021-08-15,CH,24,PL57,34220,34184,44,44,0
2021-08-09,SD,13,PL18,75305,74977,571,176,395
2021-01-22,SB,11,PL36,290904,289392,1824,1824,0
2021-08-02,HO,18,PL01,67248,66856,392,392,0
2021-12-02,CA,23,PL31,82296,79488,2808,2808,0
2021-10-29,CH,24,PL24,5760,5760,4880,4880,0
2021-04-20,SD,13,PL17,72596,71611,1558,560,998
2021-12-05,SB,11,PL36,308568,307584,984,984,0
2021-09-03,HO,18,PL40,63976,63808,232,232,0
2021-09-28,EC,10,PL43,621264,619152,2592,2592,0
2021-06-07,PB,25,PL54,327840,310624,17216,17216,0
2021-03-10,CA,23,PL02,238104,236448,1680,1680,0
2021-12-12,SD,13,PL21,63656,63388,444,176,268
2021-01-04,NT,16,PL51,461248,461440,896,896,0
2021-06-05,SD,13,PL22,67546,66850,1081,368,713
2021-10-05,CA,23,PL13,82544,82360,232,232,0
2021-04-29,RT,21,PL05,210072,210048,24,24,0
2021-05-31,CL,14,PL45,284576,275200,8768,8768,0
2021-07-16,HO,18,PL56,58032,57184,888,888,0
2021-10-17,HO,18,PL56,64176,63920,256,256,0
2021-03-22,HO,18,PL33,65312,65072,240,240,0
2021-01-09,DI,19,PL53,292704,292672,608,608,0
2021-02-15,RA,17,PL34,192744,191928,816,816,0
2021-12-19,DI,19,PL53,278272,277536,1152,1152,0
2021-02-22,PB,25,PL55,436768,437248,96,96,0
2021-03-16,RT,21,PL42,192448,189600,2848,2848,0
2021-03-10,HO,18,PL32,67792,67744,96,96,0
2021-03-14,RA,17,PL56,211440,196896,14760,14760,0
2021-03-10,NT,16,PL51,305344,304320,4512,4512,0
2021-10-28,PB,25,PL54,448736,448000,1408,1408,0
2021-10-11,DI,19,PL53,293664,293696,320,320,0
2021-09-01,PR,15,PL24,225056,224448,608,608,0
2021-03-21,RA,17,PL34,207264,205800,1632,1632,0
2021-08-29,PR,15,PL24,164320,163936,384,384,0
2021-01-03,CH,24,PL08,87322,83441,13206,7680,5526
2021-03-28,HO,18,PL01,65272,65200,112,112,0
2021-09-29,PR,15,PL24,267232,265664,1440,1440,0
2021-06-21,SD,13,PL25,44038,43263,5522,4704,818
2021-11-18,NT,16,PL51,511424,510976,1152,1152,0
2021-01-23,CA,23,PL13,85152,85160,96,96,0
2021-06-02,SD,13,PL17,68716,68090,1526,864,662
2021-07-29,SD,13,PL20,75656,75635,431,384,47
2021-09-02,NT,16,PL51,509568,508704,2656,2656,0
2021-11-22,HO,18,PL40,66216,65880,336,336,0
2021-10-25,HO,18,PL09,67504,67400,104,104,0
2021-03-20,SD,13,PL22,37384,37253,3795,3664,131
2021-06-02,HO,18,PL01,67064,66920,264,264,0
2021-12-20,HO,18,PL11,66288,66288,0,0,0
2021-06-20,HO,18,PL09,71536,71592,120,120,0
2021-10-20,RA,17,PL35,94104,83400,10704,10704,0
2021-10-31,SD,13,PL25,58908,57885,3039,2000,1039
2021-12-18,EC,10,PL43,623136,623280,576,576,0
2021-09-01,SD,13,PL18,44283,44057,1748,1520,228
2021-10-22,EC,10,PL43,602976,600480,3072,3072,0
2021-12-16,CH,24,PL08,271058,265050,19864,13856,6008
2021-06-30,SD,13,PL20,67006,66955,708,656,52
2021-01-09,RA,17,PL56,204672,202848,1824,1824,0
2021-02-25,RA,17,PL56,147912,140736,7176,7176,0
2021-10-23,CA,23,PL31,109272,108888,816,816,0
2021-03-09,CA,23,PL13,84432,84296,208,208,0
2021-05-17,CH,24,PL57,33524,33508,60,60,0
2021-03-27,RT,21,PL06,188880,186672,2784,2784,0
2021-09-11,PRG,12,PL14,390912,389952,1952,1952,0
2021-12-20,CA,23,PL13,84560,84344,400,400,0
2021-02-20,HO,18,PL11,66256,66248,8,8,0
2021-05-09,SD,13,PL21,66664,66113,1527,976,551
2021-11-15,HO,18,PL01,67552,67288,264,264,0
2021-05-24,SD,13,PL18,0,0,0,0,0
2021-11-02,CA,23,PL02,179112,178416,984,984,0
2021-01-26,DI,19,PL52,296960,296864,416,416,0
2021-09-03,NT,16,PL51,514816,514304,960,960,0
2021-12-20,SD,13,PL19,75083,74987,272,176,96
2021-05-06,SD,13,PL25,61996,59590,2774,368,2406
2021-05-25,CH,24,PL08,208096,201502,11878,5152,6726
2021-07-20,EC,10,PL43,267456,266496,864,864,0
2021-01-31,CA,23,PL31,196488,194712,3216,3216,0
2021-01-11,SD,13,PL22,67405,67318,337,224,113
2021-03-07,CA,23,PL02,236784,233232,3888,3888,0
2021-03-23,CH,24,PL12,157360,155072,2544,2544,0
2021-06-13,HO,18,PL40,66328,66328,0,0,0
2021-08-09,EC,10,PL43,628416,627120,1632,1632,0
2021-06-15,NT,16,PL51,362304,344672,26432,26432,0
2021-12-22,SD,13,PL19,66138,65988,374,224,150
2021-02-19,PRG,12,PL12,394336,393760,832,832,0
2021-05-07,RA,17,PL56,222264,222384,0,0,0
2021-04-23,PR,15,PL57,117584,116976,608,608,0
2021-12-21,CH,24,PL08,278681,272583,13152,6976,6176
2021-08-29,CH,24,PL07,273385,269415,18001,13920,4081
2021-12-16,RT,21,PL06,171504,150120,21384,21384,0
2021-01-12,DI,19,PL52,268416,267328,2816,2816,0
2021-04-07,PR,15,PL04,264256,262368,2400,2400,0
2021-07-26,CA,23,PL31,146328,143544,2928,2928,0
2021-03-12,RT,21,PL42,168320,161584,6736,6736,0
2021-02-18,HO,18,PL09,68232,67944,288,288,0
2021-06-21,SB,11,PL50,461984,461312,1280,1280,0
2021-01-19,HO,18,PL33,67592,67464,232,232,0
2021-02-08,RT,21,PL06,205824,205488,552,552,0
2021-12-15,EC,10,PL43,622128,621696,672,672,0
2021-10-24,HO,18,PL56,66176,66056,120,120,0
2021-03-22,PR,15,PL24,264320,263936,704,704,0
2021-01-31,CH,24,PL07,187322,176687,14575,3808,10767
2021-03-29,HO,18,PL10,28736,26864,1872,1872,0
2021-12-05,CH,24,PL57,33932,33876,84,84,0
2021-04-29,PB,25,PL54,435168,431424,5440,5440,0
2021-05-30,CA,23,PL31,230712,229824,1056,1056,0
2021-06-24,PRG,12,PL14,394912,394208,992,992,0
2021-05-22,CH,24,PL08,270417,266975,18514,15072,3442
2021-03-18,EC,10,PL43,325008,315216,19056,19056,0
2021-07-07,PR,15,PL24,263616,263552,640,640,0
2021-09-12,SB,11,PL50,448160,446592,1984,1984,0
2021-04-17,SD,13,PL20,59743,59695,238,176,62
2021-01-07,CA,23,PL02,146832,140952,6192,6192,0
2021-05-17,DI,19,PL52,26624,26944,1184,1184,0
2021-09-24,HO,18,PL40,66288,66288,0,0,0
2021-02-11,SD,13,PL21,71451,70377,1506,432,1074
2021-05-06,HO,18,PL30,63432,63392,136,136,0
2021-05-07,CH,24,PL07,162618,150519,19299,7200,12099
2021-01-29,HO,18,PL01,42624,41720,1000,1000,0
2021-12-09,SD,13,PL21,55164,53620,2184,640,1544
2021-09-19,SD,13,PL20,70352,70295,601,544,57
2021-04-25,RA,17,PL56,219144,218304,984,984,0
2021-08-09,CH,24,PL08,226577,212155,25075,7616,17459
2021-10-29,RA,17,PL35,67584,66528,1056,1056,0
2021-03-03,SD,13,PL17,22987,22708,5895,5616,279
2021-01-29,RA,17,PL35,220824,220656,504,504,0
2021-11-28,CL,14,PL45,294176,292096,1248,1248,0
2021-03-03,NT,16,PL57,153296,153008,416,416,0
2021-03-09,RT,21,PL05,197088,196752,480,480,0
2021-04-26,PB,25,PL55,429184,411584,18880,18880,0
2021-05-25,HO,18,PL30,48592,48360,232,232,0
2021-11-27,CL,14,PL45,294848,281504,3200,3200,0
2021-12-03,PR,15,PL04,262656,262752,608,608,0
2021-09-17,HO,18,PL01,66696,66256,584,584,0
2021-05-13,HO,18,PL09,0,0,680,680,0
2021-06-13,RT,21,PL05,201696,197448,4248,4248,0
2021-03-26,CL,14,PL44,75520,70240,4544,4544,0
2021-09-10,PB,25,PL55,86720,26208,60512,60512,0
2021-07-02,DI,19,PL52,289472,285984,3520,3520,0
2021-10-05,SD,13,PL18,45697,44917,5274,3488,1786
2021-12-07,PRG,12,PL54,0,0,800,800,0
2021-12-01,CA,23,PL31,114624,110880,3864,3864,0
2021-04-13,SD,13,PL17,13334,13214,7996,6416,1580
2021-06-29,SD,13,PL18,76404,75776,820,192,628
2021-05-30,PRG,12,PL14,390464,390496,864,864,0
2021-09-04,CL,14,PL45,168704,64000,4384,4384,0
2021-01-08,DI,19,PL53,277056,275808,2080,2080,0
2021-05-16,HO,18,PL33,54840,53000,1840,1840,0
2021-11-10,PRG,12,PL12,385408,383392,2016,2016,0
2021-10-19,CH,24,PL57,34156,34152,44,44,0
2021-04-17,HO,18,PL03,33264,33232,136,136,0
2021-01-22,HO,18,PL09,72488,72440,112,112,0
2021-08-30,SD,13,PL17,71286,70684,1023,368,655
2021-03-25,CA,23,PL13,85264,85232,96,96,0
2021-09-16,HO,18,PL11,66320,66320,0,0,0
2021-10-14,CA,23,PL31,156048,155208,1008,1008,0
2021-02-07,RT,21,PL42,128000,126016,2624,2624,0
2021-05-30,PR,15,PL12,139872,139696,176,176,0
2021-07-05,RT,21,PL06,26952,26736,5232,5232,0
2021-08-01,HO,18,PL03,66512,66488,136,136,0
2021-09-06,HO,18,PL40,65704,65520,224,224,0
2021-09-02,RT,21,PL41,99696,90640,9072,9072,0
2021-03-01,DI,19,PL53,295584,295360,768,768,0
2021-01-23,PR,15,PL04,259520,258912,864,864,0
2021-05-21,PRG,12,PL14,381408,377536,4032,4032,0
2021-01-22,EC,10,PL43,596400,592320,4128,4128,0
2021-03-10,SD,13,PL18,3422,3409,13,0,13
2021-06-11,HO,18,PL10,33896,33488,408,408,0
2021-12-09,SD,13,PL17,61191,60872,4319,4000,319
2021-12-13,SD,13,PL21,70903,70277,848,208,640
2021-05-08,HO,18,PL01,66200,66088,112,112,0
2021-05-17,CH,24,PL12,164240,163968,368,368,0
2021-07-19,PR,15,PL12,134224,133824,912,912,0
2021-12-22,CA,23,PL13,71560,71384,360,360,0
2021-04-06,CL,14,PL45,0,0,5504,5504,0
2021-08-22,CA,23,PL13,77816,77704,264,264,0
2021-10-10,SD,13,PL17,70275,70100,697,512,185
2021-12-15,SD,13,PL25,64241,63550,899,208,691
2021-01-23,EC,10,PL43,613488,609744,3504,3504,0
2021-02-27,RA,17,PL35,174696,168072,6936,6936,0
2021-06-02,RA,17,PL35,160320,157248,3336,3336,0
2021-11-15,CH,24,PL24,157040,155168,2144,2144,0
2021-05-30,RT,21,PL06,207840,205608,2232,2232,0
2021-12-05,HO,18,PL33,69328,69384,128,128,0
2021-09-01,RT,21,PL42,59728,57600,2272,2272,0
2021-11-22,HO,18,PL30,0,0,2480,2480,0
2021-01-18,CA,23,PL02,223800,218616,5424,5424,0
2021-05-06,CH,24,PL57,1972,1916,56,56,0
2021-01-17,SD,13,PL25,67646,66713,933,0,933
2021-07-07,CL,14,PL44,279616,277920,1056,1056,0
2021-01-21,RA,17,PL35,150360,143904,6672,6672,0
2021-11-01,PW,26,PL37,815424,814320,1440,1440,0
2021-12-08,CA,23,PL31,227616,226872,1056,1056,0
2021-01-23,HO,18,PL10,56968,56824,144,144,0
2021-10-22,PRG,12,PL14,310560,309440,1056,1056,0
2021-11-02,CA,23,PL31,0,0,1440,1440,0
2021-01-30,RA,17,PL34,211656,208440,3720,3720,0
2021-03-17,HO,18,PL03,66224,66224,0,0,0
2021-05-02,HO,18,PL01,31288,30488,800,800,0
2021-06-11,SD,13,PL21,75529,74924,827,208,619
2021-12-14,SD,13,PL22,2950,2903,255,208,47
2021-09-17,PR,15,PL24,264448,263904,1248,1248,0
2021-01-17,PR,15,PL04,262496,259488,3360,3360,0
2021-03-03,PRG,12,PL14,299936,298912,1568,1568,0
2021-02-05,EC,10,PL43,606144,604656,1344,1344,0
2021-05-30,RA,17,PL34,222624,222384,528,528,0
2021-06-28,CA,23,PL02,166248,164904,2328,2328,0
2021-11-09,RA,17,PL34,254952,249456,5808,5808,0
2021-11-22,HO,18,PL01,59368,58600,768,768,0
2021-12-11,SB,11,PL36,239040,235152,4104,4104,0
2021-09-24,SB,11,PL50,454688,453568,1632,1632,0
2021-11-24,SD,13,PL20,74988,74765,876,624,252
2021-08-21,SD,13,PL19,74916,74850,258,192,66
2021-06-08,PR,15,PL12,129888,130704,864,864,0
2021-11-24,PW,26,PL37,815808,815712,1152,1152,0
2021-09-30,HO,18,PL03,66928,66848,88,88,0
2021-02-06,HO,18,PL33,68000,67752,288,288,0
2021-02-20,HO,18,PL10,56672,56712,120,120,0
2021-01-17,SB,11,PL50,450752,442784,9184,9184,0
2021-01-28,CL,14,PL44,289536,283136,1216,1216,0
2021-03-02,HO,18,PL11,65112,64936,176,176,0
2021-12-05,HO,18,PL03,66224,66224,0,0,0
2021-06-19,SD,13,PL25,12992,12860,1092,960,132
2021-03-26,RA,17,PL34,70608,70752,1608,1608,0
2021-08-14,EC,10,PL43,631104,630816,768,768,0
2021-07-27,CH,24,PL08,224299,223474,13746,4704,9042
2021-11-06,RT,21,PL06,205776,205776,288,288,0
2021-11-17,SB,11,PL50,464832,464352,1408,1408,0
2021-08-09,PB,25,PL54,292992,283744,10048,10048,0
2021-07-21,HO,18,PL33,65120,65096,96,96,0
2021-02-17,PRG,12,PL14,359360,355232,4352,4352,0
2021-03-06,NT,16,PL57,155168,154992,320,320,0
2021-03-15,RA,17,PL34,220560,220008,552,552,0
2021-10-12,RT,21,PL41,11776,0,11776,11776,0
2021-02-08,RA,17,PL34,195360,191568,3792,3792,0
2021-08-14,HO,18,PL09,72152,72160,88,88,0
2021-11-22,SB,11,PL50,419488,419328,5536,5536,0
2021-06-21,CL,14,PL45,295552,290144,4704,4704,0
2021-10-31,SB,11,PL36,191400,185232,6216,6216,0
2021-07-04,PW,26,PL37,689184,686208,4800,4800,0
2021-08-10,HO,18,PL33,66224,66224,0,0,0
2021-07-23,SD,13,PL19,63572,63270,494,192,302
2021-02-20,HO,18,PL32,67400,66224,1272,1272,0
2021-01-31,CL,14,PL44,302080,297504,1184,1184,0
2021-07-18,PR,15,PL12,139312,139072,240,240,0
2021-03-12,SD,13,PL21,73458,73093,612,192,420
2021-06-24,RT,21,PL42,188976,183840,5424,5424,0
2021-03-15,PR,15,PL04,169792,153984,16224,16224,0
2021-09-10,HO,18,PL10,68352,68272,328,328,0
2021-12-17,PB,25,PL55,353472,343232,11168,11168,0
2021-03-07,SD,13,PL21,53976,50735,3946,624,3322
2021-07-13,HO,18,PL56,57384,56624,760,760,0
2021-03-09,CH,24,PL08,289143,287252,9623,7680,1943
2021-03-06,CH,24,PL07,275833,271863,11829,7488,4341
2021-11-28,PB,25,PL55,448192,445856,3168,3168,0
2021-05-08,SD,13,PL25,51557,51123,5634,5200,434
2021-09-27,RA,17,PL35,230400,229368,1320,1320,0
2021-09-14,SD,13,PL25,75787,74744,1411,368,1043
2021-09-02,PR,15,PL24,254688,254368,3424,3424,0
2021-01-27,DI,19,PL52,295712,296032,352,352,0
2021-09-06,SD,13,PL25,44952,44419,901,368,533
2021-12-06,CH,24,PL08,302884,295905,15651,8672,6979
2021-03-31,RA,17,PL35,75552,72408,3144,3144,0
2021-08-17,SD,13,PL22,25098,25175,14,0,14
2021-12-15,PR,15,PL24,264064,259936,4800,4800,0
2021-11-02,PB,25,PL54,401216,394336,7872,7872,0
2021-04-06,PRG,12,PL14,279296,278496,5376,5376,0
2021-09-22,SD,13,PL19,75662,75610,71,0,71
2021-10-22,PB,25,PL55,449376,449728,960,960,0
2021-04-30,CA,23,PL02,230160,229944,432,432,0
2021-08-05,PR,15,PL12,133648,133200,992,992,0
2021-04-16,HO,18,PL09,73064,73144,0,0,0
2021-11-24,CL,14,PL45,247904,243072,1408,1408,0
2021-04-06,RA,17,PL35,189528,188040,2040,2040,0
2021-10-06,SD,13,PL17,74352,74152,744,528,216
2021-06-02,DI,19,PL52,208160,205376,3168,3168,0
2021-11-03,CH,24,PL08,14715,14135,1700,1120,580
2021-07-22,CA,23,PL11,0,0,168,168,0
2021-05-07,HO,18,PL09,65856,64264,1624,1624,0
2021-06-16,HO,18,PL40,66232,66280,0,0,0
2021-03-11,PB,25,PL55,400576,388352,12864,12864,0
2021-05-20,PRG,12,PL14,387488,387328,1568,1568,0
2021-02-03,SB,11,PL36,227160,225888,1272,1272,0
2021-01-26,CA,23,PL13,85248,85192,88,88,0
2021-11-13,CA,23,PL31,113112,111456,2016,2016,0
2021-09-21,HO,18,PL30,0,0,0,0,0
2021-01-28,CH,24,PL08,302560,292840,17539,7808,9731
2021-07-03,RT,21,PL42,194000,193520,704,704,0
2021-05-15,CH,24,PL12,152288,150672,1792,1792,0
2021-01-25,CH,24,PL08,296033,290902,14475,9344,5131
2021-09-28,DI,19,PL52,290208,290112,352,352,0
2021-12-14,CA,23,PL35,77520,77528,80,80,0
2021-05-10,PRG,12,PL14,391040,390432,1504,1504,0
2021-06-11,HO,18,PL33,132496,132496,0,0,0
2021-08-06,HO,18,PL01,41776,41280,496,496,0
2021-02-15,SB,11,PL36,200760,196584,5688,5688,0
2021-02-20,PR,15,PL24,262112,261024,1536,1536,0
2021-02-12,RA,17,PL56,217344,216888,696,696,0
2021-04-06,PR,15,PL04,234176,233376,3584,3584,0
2021-06-26,RT,21,PL06,206208,206016,408,408,0
2021-07-14,CH,24,PL08,144738,144108,10736,10016,720
2021-06-09,SD,13,PL22,62078,61483,595,0,595
2021-11-19,SB,11,PL36,212232,210576,8160,8160,0
2021-04-08,HO,18,PL01,66200,66104,96,96,0
2021-07-11,HO,18,PL33,66200,66200,0,0,0
2021-07-25,RT,21,PL05,206880,206616,264,264,0
2021-03-23,SD,13,PL20,53599,53282,1854,1488,366
2021-10-31,CA,23,PL13,85232,85176,88,88,0
2021-11-13,RT,21,PL06,172080,167424,4776,4776,0
2021-01-19,SD,13,PL25,70475,70254,589,368,221
2021-04-20,HO,18,PL09,63888,61240,2912,2912,0
2021-01-14,DI,19,PL52,299360,299648,0,0,0
2021-09-24,SD,13,PL18,72132,71433,1083,384,699
2021-03-19,RA,17,PL56,86760,85848,912,912,0
2021-06-22,CH,24,PL07,295043,275882,24154,4832,19322
2021-06-21,PR,15,PL12,139520,139552,176,176,0
2021-07-09,SD,13,PL18,37706,37626,656,576,80
2021-04-08,HO,18,PL11,65344,65176,168,168,0
2021-06-04,SD,13,PL22,45140,44739,1834,1376,458
2021-08-07,SD,13,PL17,67844,60279,7824,272,7552
2021-08-29,SD,13,PL21,43772,42988,1232,448,784
2021-11-16,NT,16,PL51,508736,508832,384,384,0
2021-11-09,PRG,12,PL12,64032,63488,544,544,0
2021-05-05,RT,21,PL05,206592,206688,264,264,0
2021-10-31,SD,13,PL18,72488,71662,1607,768,839
2021-04-28,RT,21,PL42,175008,171936,4384,4384,0
2021-02-15,SD,13,PL21,48474,47756,1630,912,718
2021-03-15,RT,21,PL05,206952,206880,312,312,0
2021-06-21,SD,13,PL22,75084,74569,579,48,531
2021-09-18,RT,21,PL05,204744,204864,264,264,0
2021-02-06,HO,18,PL30,66160,66144,0,0,0
2021-01-17,CH,24,PL57,33752,33680,128,128,0
2021-09-11,SB,11,PL50,462944,462464,1312,1312,0
2021-02-06,CH,24,PL08,212294,203193,18609,9184,9425
2021-07-11,HO,18,PL32,67624,67560,88,88,0
2021-05-25,RT,21,PL42,189344,185968,3488,3488,0
2021-10-18,RT,21,PL41,173696,170128,3696,3696,0
2021-11-06,RT,21,PL41,38656,35488,3168,3168,0
2021-11-28,CH,24,PL08,262368,258816,3552,3552,0
2021-09-13,SD,13,PL19,76497,76431,66,0,66
2021-02-16,PW,26,PL37,816864,815760,2112,2112,0
2021-12-14,SD,13,PL18,64655,63943,4840,4112,728
2021-06-19,PR,15,PL24,262656,261888,1376,1376,0
2021-10-26,HO,18,PL32,56216,56120,96,96,0
2021-09-25,CH,24,PL08,296763,293147,10592,6976,3616
2021-10-02,PB,25,PL55,310560,295424,27904,27904,0
2021-03-04,CL,14,PL44,264384,254464,6880,6880,0
2021-09-26,HO,18,PL09,68552,68552,0,0,0
2021-11-02,CA,23,PL13,83832,83792,96,96,0
2021-07-02,SD,13,PL20,68990,68866,698,560,138
2021-10-30,CL,14,PL44,219776,213344,6144,6144,0
2021-07-04,PR,15,PL24,264160,264064,640,640,0
2021-07-01,PR,15,PL24,265632,265536,480,480,0
2021-05-06,SD,13,PL18,73018,72740,454,176,278
2021-10-08,SB,11,PL50,349728,346400,3712,3712,0
2021-01-26,SD,13,PL22,59682,59368,1082,768,314
2021-07-28,HO,18,PL03,67216,67248,104,104,0
2021-09-28,PR,15,PL04,6688,6656,4064,4064,0
2021-02-11,HO,18,PL10,56064,55920,144,144,0
2021-04-23,RA,17,PL35,189096,189072,624,624,0
2021-09-08,SD,13,PL20,69610,69434,928,736,192
2021-09-09,PR,15,PL24,130432,122336,8160,8160,0
2021-02-05,PRG,12,PL14,315872,303968,12256,12256,0
2021-07-19,RT,21,PL05,205032,204792,1080,1080,0
2021-10-31,RT,21,PL05,135288,133008,2256,2256,0
2021-08-09,HO,18,PL09,69352,69088,264,264,0
2021-11-14,HO,18,PL32,57072,57016,88,88,0
2021-05-02,HO,18,PL32,68512,68512,0,0,0
2021-10-01,HO,18,PL33,126464,125600,1264,1264,0
2021-06-01,PR,15,PL12,82256,82080,384,384,0
2021-07-04,RA,17,PL34,164184,162024,2160,2160,0
2021-10-08,NT,16,PL51,210784,208992,1792,1792,0
2021-09-27,RA,17,PL34,188496,183936,4968,4968,0
2021-11-08,RT,21,PL42,78400,75168,3392,3392,0
2021-05-15,PW,26,PL37,765888,759168,8880,8880,0
2021-04-30,CL,14,PL45,21696,0,10016,10016,0
2021-11-21,PR,15,PL04,263616,263072,544,544,0
2021-04-10,SD,13,PL22,76175,76086,265,176,89
2021-09-10,HO,18,PL56,66224,66224,0,0,0
2021-10-17,EC,10,PL43,631920,632256,48,48,0
2021-01-10,HO,18,PL11,66288,66288,0,0,0
2021-11-15,CA,23,PL02,184368,184080,1080,1080,0
2021-09-19,PW,26,PL37,813888,810336,3552,3552,0
2021-10-11,SD,13,PL19,72202,71939,634,384,250
2021-01-15,CH,24,PL08,289072,276373,19341,6656,12685
2021-03-26,SD,13,PL21,48064,47833,1310,1040,270
2021-11-08,RA,17,PL34,151944,144864,7320,7320,0
2021-05-09,CH,24,PL08,297339,282265,20162,4896,15266
2021-12-21,RA,17,PL56,260880,260328,720,720,0
2021-08-03,HO,18,PL40,62576,61952,624,624,0
2021-03-20,RT,21,PL06,187176,185832,1344,1344,0
2021-10-07,SD,13,PL25,65441,65062,1808,1360,448
2021-03-09,RT,21,PL42,154176,135712,18720,18720,0
2021-05-19,PR,15,PL04,248832,247968,896,896,0
2021-09-18,SB,11,PL36,308304,301824,6672,6672,0
2021-01-15,SB,11,PL50,386304,382624,4832,4832,0
2021-08-07,CH,24,PL57,34128,34072,56,56,0
2021-05-18,CH,24,PL57,20664,20580,200,200,0
2021-09-26,CA,23,PL02,212064,211392,672,672,0
2021-06-25,NT,16,PL51,512384,510816,1888,1888,0
2021-03-20,RA,17,PL35,201600,197040,4560,4560,0
2021-09-20,CL,14,PL44,295552,292192,3104,3104,0
2021-09-20,RA,17,PL35,220296,219072,1488,1488,0
2021-01-19,SD,13,PL20,56765,56650,935,752,183
2021-03-12,CA,23,PL31,223296,220248,3192,3192,0
2021-05-29,RA,17,PL35,219936,214848,5088,5088,0
2021-06-15,CH,24,PL07,259019,252596,10295,3872,6423
2021-06-03,SD,13,PL19,55829,55382,3359,2912,447
2021-02-03,HO,18,PL09,72056,71616,432,432,0
2021-03-16,SB,11,PL50,411136,409536,6784,6784,0
2021-11-26,CH,24,PL57,29192,29144,48,48,0
2021-11-27,PRG,12,PL14,388480,387776,1728,1728,0
2021-04-08,SD,13,PL22,74787,74700,455,368,87
2021-05-17,NT,16,PL51,466816,466720,576,576,0
2021-01-28,CA,23,PL31,228984,224856,4560,4560,0
2021-08-12,HO,18,PL33,54728,54048,728,728,0
2021-01-22,PRG,12,PL12,393280,392576,800,800,0
2021-02-24,CH,24,PL04,162816,162352,512,512,0
2021-08-26,SD,13,PL17,64640,63016,2216,576,1640
2021-10-14,DI,19,PL53,295776,295712,384,384,0
2021-12-10,HO,18,PL09,63424,62616,912,912,0
2021-02-03,RT,21,PL42,31936,12880,20272,20272,0
2021-03-23,SB,11,PL50,316384,309984,7136,7136,0
2021-03-24,SD,13,PL18,0,0,272,272,0
2021-08-24,CA,23,PL13,85064,84888,176,176,0
2021-08-24,PR,15,PL24,249088,230176,19424,19424,0
2021-02-14,DI,19,PL53,297920,297408,1280,1280,0
2021-06-20,HO,18,PL40,65192,65120,104,104,0
2021-10-21,HO,18,PL01,66168,64584,1608,1608,0
2021-03-19,HO,18,PL30,64936,64560,376,376,0
2021-07-07,SD,13,PL17,67287,66387,3353,2384,969
2021-03-07,HO,18,PL33,67768,67712,200,200,0
2021-04-19,CH,24,PL12,93744,94128,192,192,0
2021-07-27,SD,13,PL20,72545,72526,281,208,73
2021-08-24,CA,23,PL31,194904,193272,1896,1896,0
2021-06-23,HO,18,PL40,65608,65504,104,104,0
2021-08-10,SD,13,PL20,600,400,1384,1184,200
2021-01-10,PB,25,PL55,410752,383424,29312,29312,0
2021-03-04,HO,18,PL09,69288,68824,464,464,0
2021-07-04,SB,11,PL36,298128,292296,5832,5832,0
2021-06-01,SD,13,PL22,68177,67554,799,176,623
2021-06-20,DI,19,PL53,196512,194272,2400,2400,0
2021-04-08,DI,19,PL53,278784,277824,1376,1376,0
2021-07-03,SD,13,PL22,75294,75220,266,192,74
2021-05-06,PB,25,PL54,117856,113984,3872,3872,0
2021-08-06,HO,18,PL09,21896,21816,80,80,0
2021-12-05,HO,18,PL32,57168,57080,88,88,0
2021-09-04,CA,23,PL31,216024,211824,4320,4320,0
2021-02-03,CH,24,PL04,164976,163984,1056,1056,0
2021-11-25,HO,18,PL32,54424,54288,136,136,0
2021-09-26,PR,15,PL24,268576,268192,384,384,0
2021-09-05,SD,13,PL25,13726,13462,264,0,264
2021-04-14,CA,23,PL31,190224,187440,3120,3120,0
2021-09-02,SD,13,PL21,70961,70494,2931,2448,483
2021-01-15,HO,18,PL09,48512,48272,592,592,0
2021-05-04,RA,17,PL35,225840,223800,1704,1704,0
2021-06-19,PB,25,PL55,446240,445728,3200,3200,0
2021-12-07,PB,25,PL55,451840,447904,4320,4320,0
2021-01-22,PW,26,PL37,740880,704256,37440,37440,0
2021-10-09,SD,13,PL19,76137,75880,641,384,257
2021-03-24,RA,17,PL56,213384,206472,6912,6912,0
2021-02-07,HO,18,PL11,63920,63552,368,368,0
2021-04-25,CH,24,PL12,126352,124800,1744,1744,0
2021-02-01,PRG,12,PL12,390976,391264,928,928,0
2021-05-20,CA,23,PL31,210816,201816,9240,9240,0
2021-04-13,DI,19,PL52,142880,132256,11008,11008,0
2021-01-14,SD,13,PL18,71074,70485,1025,384,641
2021-10-20,SB,11,PL36,299424,288120,11688,11688,0
2021-12-20,HO,18,PL09,65176,64944,232,232,0
2021-05-11,RA,17,PL35,201072,199800,1872,1872,0
2021-09-04,SB,11,PL50,377088,370848,6752,6752,0
2021-03-03,SB,11,PL50,438336,436864,2912,2912,0
2021-05-31,RT,21,PL05,206232,206088,720,720,0
2021-11-27,HO,18,PL40,66136,65968,168,168,0
2021-04-16,RT,21,PL06,86856,78816,8040,8040,0
2021-06-28,HO,18,PL01,66008,65864,192,192,0
2021-01-16,RT,21,PL06,207936,207864,288,288,0
2021-02-19,RA,17,PL35,216480,214968,2136,2136,0
2021-04-23,RT,21,PL05,130224,119808,10416,10416,0
2021-10-31,RA,17,PL35,256776,252816,4200,4200,0
2021-10-17,SD,13,PL21,64401,64162,607,368,239
2021-05-09,RA,17,PL34,220392,220320,312,312,0
2021-06-28,DI,19,PL53,293120,292064,1536,1536,0
2021-06-11,CA,23,PL11,234888,233280,1680,1680,0
2021-02-23,RA,17,PL35,220440,219600,1056,1056,0
2021-04-27,RA,17,PL56,50880,50568,1176,1176,0
2021-06-11,SD,13,PL22,56464,56010,3020,2512,508
2021-02-08,EC,10,PL43,612384,610608,1872,1872,0
2021-04-28,HO,18,PL30,62456,62432,288,288,0
2021-08-05,RT,21,PL42,181968,180400,1728,1728,0
2021-03-13,HO,18,PL10,55136,54920,296,296,0
2021-03-09,PRG,12,PL14,58144,52576,5568,5568,0
2021-06-18,DI,19,PL52,283488,272736,11072,11072,0
2021-04-17,CH,24,PL08,92521,88794,8034,3808,4226
2021-11-28,SD,13,PL19,61928,61868,445,384,61
2021-11-04,SD,13,PL18,74357,73930,1790,1296,494
2021-02-22,SD,13,PL17,74697,74603,94,0,94
2021-06-27,RT,21,PL05,208080,208344,48,48,0
2021-09-20,RT,21,PL05,204120,203088,1488,1488,0
2021-05-01,SD,13,PL18,67961,67812,1046,896,150
2021-11-28,CH,24,PL07,281905,274058,10791,2944,7847
2021-09-21,SD,13,PL20,52423,51387,1212,176,1036
2021-01-14,CL,14,PL44,303872,290560,1696,1696,0
2021-02-28,PR,15,PL24,263936,262528,1728,1728,0
2021-01-20,PW,26,PL37,780864,727248,54768,54768,0
2021-10-06,HO,18,PL33,132512,132640,0,0,0
2021-03-26,NT,16,PL51,29568,29568,4736,4736,0
2021-06-04,RT,21,PL41,23360,14320,8912,8912,0
2021-09-19,PR,15,PL24,267232,266240,1376,1376,0
2021-11-05,HO,18,PL11,61944,61272,896,896,0
2021-08-29,HO,18,PL09,44584,44488,96,96,0
2021-07-14,PR,15,PL12,92800,90368,2432,2432,0
2021-09-18,PR,15,PL24,267552,266400,1600,1600,0
2021-10-15,RT,21,PL05,205968,205536,576,576,0
2021-11-28,PR,15,PL04,264992,264608,576,576,0
2021-02-28,RA,17,PL56,222744,222744,0,0,0
2021-08-27,SD,13,PL20,76412,76390,211,176,35
2021-10-04,HO,18,PL11,66240,66008,232,232,0
2021-07-01,HO,18,PL40,65728,65304,424,424,0
2021-12-08,HO,18,PL11,66288,66288,0,0,0
2021-03-03,SB,11,PL36,288360,286152,6840,6840,0
2021-03-08,SD,13,PL17,72339,72050,737,448,289
2021-07-29,HO,18,PL10,60160,59752,608,608,0
2021-10-26,PB,25,PL55,448544,448768,1248,1248,0
2021-02-05,RT,21,PL06,207600,207480,384,384,0
2021-11-28,CA,23,PL13,47008,41280,5976,5976,0
2021-03-24,PB,25,PL55,441664,425440,17216,17216,0
2021-01-31,RT,21,PL05,203064,200304,3072,3072,0
2021-07-03,HO,18,PL33,65736,65640,96,96,0
2021-06-29,HO,18,PL03,64656,64208,584,584,0
2021-04-13,EC,10,PL43,596880,592368,4320,4320,0
2021-08-27,CH,24,PL08,296833,293164,6292,2144,4148
2021-07-04,SD,13,PL19,55541,55457,84,0,84
2021-06-09,SD,13,PL21,75562,75038,914,368,546
2021-11-21,SD,13,PL17,58674,58147,757,176,581
2021-06-19,SD,13,PL21,73126,72477,1488,832,656
2021-10-14,CH,24,PL12,162864,162688,176,176,0
2021-01-21,HO,18,PL33,67696,67736,96,96,0
2021-06-19,PR,15,PL12,139472,139296,176,176,0
2021-07-30,HO,18,PL01,68176,67904,272,272,0
2021-11-14,CA,23,PL02,234168,233880,672,672,0
2021-03-29,EC,10,PL43,555696,535968,19296,19296,0
2021-09-11,CH,24,PL08,314235,308926,9899,4544,5355
2021-12-05,PW,26,PL37,802176,802992,2448,2448,0
2021-09-29,RA,17,PL35,49488,45552,4464,4464,0
2021-02-16,CA,23,PL13,79584,79512,240,240,0
2021-09-07,NT,16,PL51,497408,497344,1088,1088,0
2021-05-19,HO,18,PL30,66128,66160,0,0,0
2021-07-10,HO,18,PL03,66872,66488,456,456,0
2021-04-16,PB,25,PL55,446848,447168,992,992,0
2021-01-04,HO,18,PL11,54968,55176,2576,2576,0
2021-09-23,RT,21,PL05,208728,208704,24,24,0
2021-08-16,PB,25,PL55,446496,446144,1280,1280,0
2021-01-02,RT,21,PL06,96360,91848,4512,4512,0
2021-05-09,RA,17,PL56,220392,220248,312,312,0
2021-10-06,DI,19,PL52,289696,289696,352,352,0
2021-11-07,DI,19,PL52,290144,288928,1920,1920,0
2021-12-05,PRG,12,PL14,39456,38528,928,928,0
2021-02-05,HO,18,PL30,64064,63688,392,392,0
2021-06-29,PW,26,PL37,816576,816048,2112,2112,0
2021-02-02,PRG,12,PL12,266080,264224,2208,2208,0
2021-08-11,SD,13,PL19,71738,71553,2534,2304,230
2021-12-16,CA,23,PL35,65168,63528,1640,1640,0
2021-01-16,SB,11,PL36,310776,307464,3648,3648,0
2021-07-08,HO,18,PL10,62008,61296,760,760,0
2021-07-12,HO,18,PL01,45936,45656,280,280,0
2021-01-13,SD,13,PL22,71065,71006,687,544,143
2021-09-18,DI,19,PL52,293472,293472,0,0,0
2021-03-03,SD,13,PL25,70119,69541,1250,672,578
2021-08-04,HO,18,PL03,67608,67608,0,0,0
2021-02-02,SD,13,PL18,68127,67408,2494,1712,782
2021-09-06,HO,18,PL56,66224,66224,0,0,0
2021-10-17,HO,18,PL01,67160,66952,312,312,0
2021-11-27,HO,18,PL32,56608,56576,88,88,0
2021-04-06,CH,24,PL12,103696,103744,2160,2160,0
2021-06-23,CA,23,PL02,234456,234384,528,528,0
2021-11-11,HO,18,PL01,66688,66320,368,368,0
2021-03-24,HO,18,PL33,66232,66168,64,64,0
2021-03-04,NT,16,PL57,153696,153808,224,224,0
2021-10-09,HO,18,PL01,67784,67232,632,632,0
2021-12-09,RT,21,PL06,204816,204552,264,264,0
2021-02-01,PW,26,PL37,811200,807888,4752,4752,0
2021-09-06,SB,11,PL50,459744,458528,1792,1792,0
2021-10-11,CL,14,PL44,296672,281664,2272,2272,0
2021-05-20,CA,23,PL11,229992,228648,1800,1800,0
2021-08-16,HO,18,PL10,68440,68328,112,112,0
2021-07-05,CL,14,PL44,289216,286304,2976,2976,0
2021-08-01,HO,18,PL09,21328,20848,504,504,0
2021-05-04,SD,13,PL22,69567,69272,968,736,232
2021-02-12,CL,14,PL45,290176,277888,2560,2560,0
2021-06-24,DI,19,PL53,289344,286976,4416,4416,0
2021-04-28,CA,23,PL11,221472,220008,1800,1800,0
2021-10-14,HO,18,PL32,0,0,2184,2184,0
2021-07-19,SD,13,PL22,57876,57290,1130,544,586
2021-09-08,SD,13,PL17,70821,70577,612,368,244
2021-01-28,SD,13,PL17,68209,67925,750,400,350
2021-06-22,SD,13,PL18,73173,72689,2649,2144,505
2021-09-25,CA,23,PL31,150336,148512,2136,2136,0
2021-08-02,HO,18,PL40,65336,65048,320,320,0
2021-12-14,CA,23,PL13,76160,76160,168,168,0
2021-02-06,PRG,12,PL12,388768,388224,992,992,0
2021-05-12,CA,23,PL11,222552,220248,2520,2520,0
2021-02-22,RA,17,PL34,220248,219504,912,912,0
2021-01-21,PR,15,PL04,260288,257440,3648,3648,0
2021-02-28,HO,18,PL03,65136,64976,160,160,0
2021-03-01,NT,16,PL57,152976,152768,832,832,0
2021-12-19,SD,13,PL22,66300,66166,1734,1584,150
2021-06-25,CL,14,PL45,289056,287104,1280,1280,0
2021-06-02,PRG,12,PL14,268640,268064,576,576,0
2021-07-03,PR,15,PL12,134688,134704,720,720,0
2021-09-04,HO,18,PL40,66296,66296,0,0,0
2021-11-23,HO,18,PL33,0,0,0,0,0
2021-12-14,SD,13,PL25,58090,56269,4465,2656,1809
2021-07-14,SD,13,PL19,66573,66558,260,176,84
2021-10-01,HO,18,PL32,55176,55136,1720,1720,0
2021-02-08,RA,17,PL56,154584,150912,3672,3672,0
2021-04-15,CA,23,PL31,50784,50664,3624,3624,0
2021-01-17,PRG,12,PL12,393088,392544,832,832,0
2021-03-06,SD,13,PL19,76360,75347,1286,176,1110
2021-06-18,HO,18,PL40,66328,66328,0,0,0
2021-10-16,SD,13,PL22,0,0,6560,6560,0
2021-08-14,RA,17,PL34,224472,224472,0,0,0
2021-01-27,RT,21,PL05,205824,205800,240,240,0
2021-01-10,SD,13,PL17,67220,67082,1963,1760,203
2021-05-17,CA,23,PL11,230544,227736,3072,3072,0
2021-10-04,CA,23,PL02,153360,148944,4632,4632,0
2021-08-01,RA,17,PL34,224424,224424,0,0,0
2021-02-13,RA,17,PL56,176256,171840,4512,4512,0
2021-05-07,RA,17,PL34,220224,219576,888,888,0
2021-08-31,RT,21,PL05,205536,205440,312,312,0
2021-09-14,PB,25,PL54,0,0,352,352,0
2021-03-17,SD,13,PL17,47676,47239,1013,576,437
2021-09-02,SD,13,PL18,74296,73904,776,368,408
2021-02-14,HO,18,PL03,65384,65120,248,248,0
2021-04-17,HO,18,PL30,52896,52896,0,0,0
2021-03-07,CL,14,PL44,299744,295872,1664,1664,0
2021-06-29,EC,10,PL43,567312,565488,1728,1728,0
2021-01-03,NT,16,PL51,469536,469536,416,416,0
2021-08-06,HO,18,PL11,63720,63696,112,112,0
2021-12-08,CH,24,PL07,20470,18498,12988,4256,8732
2021-09-27,CL,14,PL44,197376,186912,10656,10656,0
2021-04-19,CH,24,PL07,173921,158094,17922,1760,16162
2021-11-23,HO,18,PL30,0,0,5312,5312,0
2021-08-11,RT,21,PL42,167712,155296,14192,14192,0
2021-03-24,RT,21,PL41,0,0,36176,36176,0
2021-05-24,CA,23,PL02,95496,88200,7896,7896,0
2021-04-06,SD,13,PL21,51572,50578,8194,7200,994
2021-05-29,SB,11,PL50,358528,341632,17696,17696,0
2021-05-24,SD,13,PL20,0,0,0,0,0
2021-10-06,NT,16,PL51,507584,508096,416,416,0
2021-02-21,CL,14,PL44,304192,295232,2528,2528,0
2021-06-19,DI,19,PL52,291040,284000,7424,7424,0
2021-09-27,PW,26,PL37,722640,717360,5712,5712,0
2021-01-23,PR,15,PL24,262400,262144,1024,1024,0
2021-02-18,SB,11,PL36,311976,311208,1008,1008,0
2021-02-19,CH,24,PL08,258048,256128,2464,2464,0
2021-07-02,RA,17,PL35,219336,215592,3744,3744,0
2021-06-24,SD,13,PL20,44350,44177,349,176,173
2021-12-04,RT,21,PL06,145488,140880,4824,4824,0
2021-03-17,HO,18,PL32,67496,67496,96,96,0
2021-04-12,HO,18,PL11,65312,65272,128,128,0
2021-05-26,SD,13,PL22,68940,68394,722,176,546
2021-09-01,SB,11,PL36,195048,194424,1224,1224,0
2021-03-22,PR,15,PL04,263968,263968,384,384,0
2021-05-10,SD,13,PL17,70959,70711,832,528,304
2021-02-10,HO,18,PL09,71672,71456,320,320,0
2021-01-13,HO,18,PL30,65672,65432,240,240,0
2021-09-24,CL,14,PL44,294240,271168,4192,4192,0
2021-02-07,SB,11,PL50,458016,456672,2048,2048,0
2021-09-16,RT,21,PL06,205728,205560,576,576,0
2021-08-02,CA,23,PL02,146112,145968,1224,1224,0
2021-11-06,HO,18,PL33,132304,132496,0,0,0
2021-05-09,PB,25,PL55,448832,448000,4416,4416,0
2021-09-23,CH,24,PL08,292903,290077,9291,6336,2955
2021-10-16,NT,16,PL51,503456,503168,960,960,0
2021-12-01,DI,19,PL53,295008,291648,3808,3808,0
2021-11-20,CA,23,PL13,83656,83576,224,224,0
2021-02-05,PR,15,PL57,142816,142592,352,352,0
2021-07-03,PR,15,PL24,268288,268288,0,0,0
2021-04-28,HO,18,PL40,59568,59568,472,472,0
2021-06-03,SD,13,PL20,66988,65929,1483,384,1099
2021-12-13,SD,13,PL18,67291,66494,1101,304,797
2021-05-07,SD,13,PL21,72223,71768,912,352,560
2021-01-28,HO,18,PL09,72720,72488,232,232,0
2021-03-21,SD,13,PL22,74244,74036,608,400,208
2021-10-29,PRG,12,PL14,131872,131776,96,96,0
2021-02-14,PRG,12,PL14,273664,254304,19584,19584,0
2021-08-04,HO,18,PL11,66048,65992,152,152,0
2021-11-19,SD,13,PL25,34935,34257,966,288,678
2021-11-06,EC,10,PL43,608064,604224,4560,4560,0
2021-02-22,PRG,12,PL14,392608,392352,768,768,0
2021-09-08,PB,25,PL55,0,0,3104,3104,0
2021-04-29,DI,19,PL53,125632,123712,1920,1920,0
2021-04-05,HO,18,PL10,57600,57672,0,0,0
2021-06-30,RT,21,PL06,204648,204240,1104,1104,0
2021-05-04,CA,23,PL31,208656,208728,432,432,0
2021-07-05,CA,23,PL11,203208,202512,1464,1464,0
2021-01-28,PRG,12,PL12,392992,392736,1184,1184,0
2021-12-11,CA,23,PL02,226416,226368,336,336,0
2021-05-20,SB,11,PL36,248808,248040,1200,1200,0
2021-11-25,PB,25,PL55,435616,381472,56864,56864,0
2021-08-06,PB,25,PL55,0,0,31552,31552,0
2021-10-02,HO,18,PL40,66288,66288,0,0,0
2021-06-27,SB,11,PL50,455040,454112,1984,1984,0
2021-11-23,SD,13,PL22,65484,65455,654,592,62
2021-10-28,SD,13,PL17,69648,69380,501,208,293
2021-01-29,SD,13,PL21,66440,64934,2122,544,1578
2021-08-19,SD,13,PL22,65774,65660,781,656,125
2021-03-22,RT,21,PL41,0,0,464,464,0
2021-09-19,SD,13,PL17,70510,69694,832,16,816
2021-10-15,SD,13,PL20,69916,69505,1678,1264,414
2021-11-10,CL,14,PL45,219008,209312,10336,10336,0
2021-09-13,CH,24,PL12,160400,157632,2816,2816,0
2021-12-04,HO,18,PL09,66192,66080,112,112,0
2021-10-22,SB,11,PL36,222432,222336,8232,8232,0
2021-11-11,RT,21,PL42,113776,97536,16976,16976,0
2021-05-15,CA,23,PL13,79984,79960,184,184,0
2021-07-16,CL,14,PL44,264480,261536,1952,1952,0
2021-11-22,SD,13,PL25,63914,61620,3237,944,2293
2021-04-28,RA,17,PL56,187968,187512,720,720,0
2021-01-19,RT,21,PL06,207024,206976,288,288,0
2021-05-20,SB,11,PL50,458432,457088,1664,1664,0
2021-11-05,HO,18,PL33,128848,128544,1872,1872,0
2021-03-02,RT,21,PL41,19184,11152,8032,8032,0
2021-09-18,HO,18,PL32,57088,57088,96,96,0
2021-02-08,CL,14,PL44,276864,268256,4160,4160,0
2021-03-01,PR,15,PL24,194496,187712,6848,6848,0
2021-07-11,PW,26,PL37,788448,763344,25920,25920,0
2021-07-31,CA,23,PL31,63696,61776,2280,2280,0
2021-05-04,HO,18,PL01,47984,46208,1776,1776,0
2021-06-22,SD,13,PL17,75919,75474,909,464,445
2021-10-09,CH,24,PL08,231210,227676,12802,8992,3810
2021-01-20,CL,14,PL44,298976,285440,2656,2656,0
2021-04-25,SD,13,PL18,74296,73776,696,176,520
2021-12-12,CA,23,PL02,230856,230256,936,936,0
2021-05-30,SB,11,PL36,41592,26520,15360,15360,0
2021-05-25,RT,21,PL06,196416,194208,2448,2448,0
2021-06-21,RA,17,PL35,183024,179448,3576,3576,0
2021-02-18,RA,17,PL35,217704,214752,2952,2952,0
2021-02-25,SD,13,PL21,73248,72708,928,352,576
2021-03-01,RT,21,PL42,190336,189424,1264,1264,0
2021-06-19,RT,21,PL06,209496,209592,24,24,0
2021-09-09,CH,24,PL08,302446,298214,7976,3744,4232
2021-11-17,SD,13,PL22,63872,63788,1560,1440,120
2021-11-10,CL,14,PL44,300800,295072,4960,4960,0
2021-12-11,HO,18,PL33,46888,45288,1808,1808,0
2021-02-15,SD,13,PL18,49904,44715,9301,4112,5189
2021-02-01,CA,23,PL13,85168,85128,120,120,0
2021-05-19,CA,23,PL13,85576,85584,96,96,0
2021-10-11,HO,18,PL09,67592,67360,232,232,0
2021-04-10,CL,14,PL45,153728,144512,6496,6496,0
2021-09-13,SD,13,PL18,76665,76310,355,0,355
2021-11-04,RA,17,PL35,154104,153312,792,792,0
2021-12-15,DI,19,PL52,219712,217888,3040,3040,0
2021-01-06,RA,17,PL35,223392,221208,2352,2352,0
2021-03-05,SD,13,PL18,74337,73213,1300,176,1124
2021-01-25,SD,13,PL20,69142,68760,1153,768,385
2021-01-03,CA,23,PL31,233112,232080,1032,1032,0
2021-08-02,RT,21,PL05,208104,207576,528,528,0
2021-06-19,CA,23,PL11,230904,228120,2928,2928,0
2021-11-17,HO,18,PL32,56776,56744,136,136,0
2021-12-13,RA,17,PL34,214392,210120,4368,4368,0
2021-10-20,HO,18,PL09,46808,46208,600,600,0
2021-02-15,PR,15,PL57,140112,139456,912,912,0
2021-04-02,HO,18,PL03,66232,66232,0,0,0
2021-04-14,RA,17,PL34,219264,218352,1176,1176,0
2021-09-24,HO,18,PL32,56424,56336,88,88,0
2021-03-01,CL,14,PL44,14112,13760,160,160,0
2021-09-17,DI,19,PL53,293952,292352,1952,1952,0
2021-10-09,NT,16,PL51,337120,335936,1184,1184,0
2021-08-14,RT,21,PL42,191152,178864,12464,12464,0
2021-09-16,CH,24,PL12,164144,163952,192,192,0
2021-06-17,SB,11,PL50,384032,371904,13120,13120,0
2021-07-30,SD,13,PL25,73117,72064,1469,416,1053
2021-03-02,CH,24,PL08,198907,195537,8426,5056,3370
2021-01-28,SD,13,PL19,60086,59808,454,176,278
2021-04-26,RA,17,PL56,222192,221640,552,552,0
2021-10-10,CH,24,PL08,250883,247307,12952,9376,3576
2021-04-07,SD,13,PL20,65156,63611,2025,480,1545
2021-10-25,CH,24,PL57,34264,34244,48,48,0
2021-01-18,CA,23,PL13,61376,61224,152,152,0
2021-05-20,PB,25,PL54,239712,223616,16704,16704,0
2021-11-05,PRG,12,PL14,390272,389408,1280,1280,0
2021-05-20,CL,14,PL44,284608,282624,1856,1856,0
2021-07-10,HO,18,PL40,65000,64992,472,472,0
2021-09-27,SB,11,PL36,310200,308856,1704,1704,0
2021-10-23,EC,10,PL43,625008,624384,672,672,0
2021-03-13,RA,17,PL56,199728,194016,5832,5832,0
2021-04-12,CH,24,PL12,162848,162720,432,432,0
2021-12-12,SD,13,PL20,14136,14027,109,0,109
2021-10-16,SD,13,PL18,68267,67396,1305,400,905
2021-10-04,HO,18,PL09,68560,68464,0,0,0
2021-01-21,CH,24,PL57,34112,34024,88,88,0
2021-11-11,HO,18,PL10,67784,67600,184,184,0
2021-02-08,CL,14,PL45,302336,292384,2080,2080,0
2021-11-16,PRG,12,PL14,390016,390272,1056,1056,0
2021-06-18,SD,13,PL19,75991,75950,473,368,105
2021-02-15,DI,19,PL53,295776,295200,736,736,0
2021-03-02,NT,16,PL57,119760,119376,512,512,0
2021-06-05,CH,24,PL57,34212,34192,44,44,0
2021-12-22,SD,13,PL25,12983,12920,1259,432,827
2021-10-23,HO,18,PL33,132496,132496,0,0,0
2021-01-21,SD,13,PL18,72998,72821,593,416,177
2021-10-18,DI,19,PL52,0,0,1408,1408,0
2021-11-26,SD,13,PL22,75554,75518,274,208,66
2021-09-12,NT,16,PL51,507680,507232,1536,1536,0
2021-01-13,SD,13,PL18,67352,65822,2189,640,1549
2021-12-16,CA,23,PL02,203736,202200,1944,1944,0
2021-05-10,RT,21,PL42,9776,0,9776,9776,0
2021-02-08,RT,21,PL41,48448,25056,23568,23568,0
2021-11-19,RA,17,PL34,214656,211464,3528,3528,0
2021-03-10,PR,15,PL24,267904,267840,256,256,0
2021-11-15,NT,16,PL51,511584,512032,352,352,0
2021-12-15,SD,13,PL21,70186,69768,2070,1632,438
2021-05-19,SD,13,PL20,75825,75534,467,176,291
2021-12-02,PRG,12,PL54,0,0,20448,20448,0
2021-03-06,SD,13,PL18,58757,56992,2540,736,1804
2021-02-10,CH,24,PL07,147239,139885,13658,6304,7354
2021-06-03,DI,19,PL53,284576,283360,1312,1312,0
2021-01-21,RT,21,PL06,206304,206112,288,288,0
2021-04-02,CA,23,PL31,204864,201888,3072,3072,0
2021-08-19,SD,13,PL18,35758,35597,2945,2496,449
2021-03-24,NT,16,PL51,447808,444928,3712,3712,0
2021-05-03,HO,18,PL09,41392,41256,296,296,0
2021-12-14,PW,26,PL37,777792,776304,2736,2736,0
2021-01-15,RA,17,PL56,219864,219768,288,288,0
2021-02-25,DI,19,PL53,295264,294560,1152,1152,0
2021-07-31,RA,17,PL34,221184,221160,360,360,0
2021-09-16,NT,16,PL51,468384,465856,2944,2944,0
2021-02-02,DI,19,PL52,102112,102112,0,0,0
2021-11-04,CA,23,PL02,194664,194424,720,720,0
2021-02-04,CH,24,PL07,239769,218074,41591,19584,22007
2021-11-26,RT,21,PL06,160704,158736,1968,1968,0
2021-05-09,PRG,12,PL14,384672,383808,1824,1824,0
2021-02-09,SD,13,PL17,69791,68397,1687,192,1495
2021-02-23,SD,13,PL22,68734,68577,573,416,157
2021-04-20,HO,18,PL03,65568,65448,120,120,0
2021-09-19,NT,16,PL51,399200,398048,1152,1152,0
2021-10-15,RT,21,PL06,204168,203280,1104,1104,0
2021-01-28,SD,13,PL20,0,0,4870,4864,6
2021-07-18,PRG,12,PL14,391168,389664,1792,1792,0
2021-09-18,PRG,12,PL14,396480,395680,1120,1120,0
2021-05-03,CA,23,PL31,234432,233520,1464,1464,0
2021-12-09,CH,24,PL08,230365,226964,9417,6016,3401
2021-03-05,SB,11,PL50,414528,412768,5568,5568,0
2021-10-01,HO,18,PL56,65768,64688,1080,1080,0
2021-11-02,HO,18,PL40,65464,65352,112,112,0
2021-12-02,SD,13,PL18,69898,69064,2070,1232,838
2021-02-05,SD,13,PL20,70619,69305,2070,768,1302
2021-04-06,NT,16,PL51,443040,443488,5056,5056,0
2021-04-07,HO,18,PL09,66568,66472,96,96,0
2021-03-04,HO,18,PL11,65696,65552,120,120,0
2021-06-21,RT,21,PL05,32160,32112,984,984,0
2021-09-18,HO,18,PL10,68560,68496,96,96,0
2021-09-17,RT,21,PL06,186624,182088,5544,5544,0
2021-02-28,CL,14,PL44,275328,260928,5760,5760,0
2021-06-05,SD,13,PL18,53772,52588,1744,560,1184
2021-10-18,CH,24,PL12,163888,163760,192,192,0
2021-05-19,CH,24,PL12,152496,152432,208,208,0
2021-05-28,RA,17,PL56,222432,221904,576,576,0
2021-09-07,CA,23,PL31,162624,161136,1488,1488,0
2021-08-07,HO,18,PL40,65656,63584,2072,2072,0
2021-09-18,HO,18,PL03,66664,66640,88,88,0
2021-02-22,CH,24,PL08,13490,13291,6627,4736,1891
2021-11-26,RT,21,PL41,30448,20848,9600,9600,0
2021-12-16,SD,13,PL25,57443,56787,2128,1472,656
2021-10-28,CH,24,PL57,33584,33492,92,92,0
2021-03-16,CA,23,PL02,0,0,4872,4872,0
2021-04-25,HO,18,PL33,63280,63192,88,88,0
2021-06-27,CA,23,PL11,236400,235704,888,888,0
2021-06-10,HO,18,PL10,56960,56872,88,88,0
2021-09-21,HO,18,PL56,34136,33688,448,448,0
2021-06-15,PW,26,PL37,815184,813168,3648,3648,0
2021-04-15,CH,24,PL07,0,0,29239,8000,21239
2021-11-07,CA,23,PL02,230928,230232,936,936,0
2021-12-10,RT,21,PL05,162024,152712,9840,9840,0
2021-02-15,HO,18,PL33,66056,65752,696,696,0
2021-02-07,HO,18,PL09,71640,71544,208,208,0
2021-08-03,HO,18,PL10,68240,68184,96,96,0
2021-10-01,DI,19,PL53,289312,287328,2016,2016,0
2021-08-24,CH,24,PL12,137824,137472,1472,1472,0
2021-04-08,RA,17,PL34,222912,223032,0,0,0
2021-01-14,HO,18,PL09,0,0,144,144,0
2021-02-06,PRG,12,PL14,388864,388832,896,896,0
2021-03-05,SD,13,PL21,66873,66431,810,368,442
2021-07-31,PR,15,PL12,138192,138304,304,304,0
2021-11-07,HO,18,PL01,66920,66576,536,536,0
2021-11-11,SD,13,PL21,0,0,789,128,661
2021-03-24,DI,19,PL53,296288,296224,384,384,0
2021-03-06,CA,23,PL13,85288,85408,112,112,0
2021-10-01,PW,26,PL37,770544,768480,12768,12768,0
2021-12-05,HO,18,PL40,66288,66288,0,0,0
2021-03-04,SD,13,PL25,73385,73357,509,384,125
2021-03-19,PR,15,PL04,263776,263200,736,736,0
2021-06-21,HO,18,PL40,66328,66328,0,0,0
2021-09-23,CA,23,PL31,220248,217344,3552,3552,0
2021-09-14,CH,24,PL08,310549,307836,6913,4000,2913
2021-12-01,RA,17,PL34,194160,189288,5088,5088,0
2021-11-05,RA,17,PL34,225120,217536,7584,7584,0
2021-11-08,PRG,12,PL12,389440,388640,800,800,0
2021-06-19,HO,18,PL10,54456,53768,752,752,0
2021-04-02,HO,18,PL11,66280,66280,0,0,0
2021-04-29,CA,23,PL13,85136,85176,88,88,0
2021-05-19,EC,10,PL43,598416,593472,4704,4704,0
2021-10-19,EC,10,PL43,621888,618912,2640,2640,0
2021-08-09,RT,21,PL41,34912,1072,33840,33840,0
2021-11-20,SD,13,PL20,75970,75833,345,208,137
2021-06-14,RT,21,PL41,0,0,0,0,0
2021-10-14,SD,13,PL21,66116,65850,458,192,266
2021-08-18,SD,13,PL20,0,0,0,0,0
2021-02-16,SB,11,PL36,298536,294384,4776,4776,0
2021-06-23,CL,14,PL45,196320,185056,11648,11648,0
2021-09-04,SD,13,PL20,56988,56943,901,848,53
2021-01-26,PRG,12,PL12,385632,385312,1408,1408,0
2021-10-03,SD,13,PL20,69682,69180,969,448,521
2021-12-10,SB,11,PL36,233568,229920,3864,3864,0
2021-07-02,HO,18,PL32,67728,67616,112,112,0
2021-10-14,HO,18,PL09,28648,28160,488,488,0
2021-11-18,SD,13,PL25,76393,75356,1229,192,1037
2021-02-20,RT,21,PL05,208008,207792,288,288,0
2021-06-17,SD,13,PL22,43858,43469,1429,1040,389
2021-11-13,HO,18,PL56,54960,54448,592,592,0
2021-01-02,PRG,12,PL14,227680,226432,1248,1248,0
2021-03-31,HO,18,PL30,66224,66224,0,0,0
2021-04-10,HO,18,PL30,66224,66224,0,0,0
2021-09-05,CL,14,PL45,242464,234848,2720,2720,0
2021-04-07,SD,13,PL21,62423,62035,2842,2448,394
2021-05-03,RA,17,PL56,218400,218184,384,384,0
2021-10-13,SD,13,PL18,71903,71637,1067,800,267
2021-11-06,SD,13,PL25,65926,64212,2094,368,1726
2021-01-30,HO,18,PL01,24208,22272,1936,1936,0
2021-12-21,CH,24,PL12,164608,164032,576,576,0
2021-03-20,PRG,12,PL14,303232,280352,23392,23392,0
2021-12-16,SD,13,PL22,25588,25522,2642,2576,66
2021-07-10,PR,15,PL24,264192,264096,416,416,0
2021-07-28,HO,18,PL09,27632,27632,0,0,0
2021-09-03,HO,18,PL03,66728,66568,184,184,0
2021-09-05,SD,13,PL22,74202,74103,771,672,99
2021-02-23,RT,21,PL05,206784,206904,288,288,0
2021-12-19,HO,18,PL01,66928,64136,2848,2848,0
2021-02-09,HO,18,PL03,62112,61712,400,400,0
2021-01-06,PRG,12,PL12,323424,321984,1632,1632,0
2021-06-22,DI,19,PL53,268512,265440,3328,3328,0
2021-03-19,NT,16,PL57,152416,151824,592,592,0
2021-09-03,HO,18,PL09,70264,68432,1832,1832,0
2021-10-07,RT,21,PL41,47280,45424,1856,1856,0
2021-08-01,HO,18,PL56,64272,63832,624,624,0
2021-09-16,CH,24,PL57,33468,33412,104,104,0
2021-05-29,CH,24,PL08,280017,271835,22581,14240,8341
2021-05-25,SD,13,PL19,25701,25694,15182,15072,110
2021-09-12,RA,17,PL35,229512,229248,648,648,0
2021-10-28,PRG,12,PL14,393664,393088,1088,1088,0
2021-12-22,CH,24,PL07,143668,137547,11433,5312,6121
2021-02-01,SD,13,PL20,0,0,0,0,0
2021-10-24,RT,21,PL06,196128,192456,4776,4776,0
2021-10-27,DI,19,PL52,175232,173472,1536,1536,0
2021-06-05,PRG,12,PL14,392096,391744,960,960,0
2021-03-18,CH,24,PL08,297369,293058,9867,5152,4715
2021-08-26,SD,13,PL21,72140,72140,928,928,0
2021-09-08,SB,11,PL36,312600,310800,2280,2280,0
2021-10-27,HO,18,PL11,66272,66272,0,0,0
2021-06-26,SD,13,PL19,76531,76488,219,176,43
2021-09-27,CL,14,PL45,293312,289920,2784,2784,0
2021-01-27,PR,15,PL24,264096,259712,4640,4640,0
2021-03-24,SD,13,PL19,30583,28931,2068,416,1652
2021-01-12,NT,16,PL51,466464,464800,1888,1888,0
2021-05-08,CA,23,PL13,85224,85144,184,184,0
2021-09-27,HO,18,PL01,67088,66704,504,504,0
2021-10-14,RT,21,PL05,160488,160296,2592,2592,0
2021-11-04,SD,13,PL17,68543,68374,745,576,169
2021-08-21,SD,13,PL25,69511,69017,937,432,505
2021-12-15,SD,13,PL17,42018,39037,2981,0,2981
2021-06-23,HO,18,PL09,62992,62880,128,128,0
2021-12-02,PB,25,PL55,448544,445856,3776,3776,0
2021-04-28,HO,18,PL32,67096,64648,2448,2448,0
2021-08-10,CH,24,PL08,275435,267678,13220,5376,7844
2021-11-16,DI,19,PL52,290976,290336,864,864,0
2021-05-06,HO,18,PL01,65160,64624,504,504,0
2021-04-21,RT,21,PL06,207648,205416,2232,2232,0
2021-09-13,SD,13,PL25,75053,74557,1167,592,575
2021-10-01,HO,18,PL03,66680,66576,328,328,0
2021-04-23,CA,23,PL31,228864,225072,3792,3792,0
2021-09-21,CH,24,PL08,304121,300952,6967,3584,3383
2021-05-31,HO,18,PL10,54504,53784,720,720,0
2021-08-25,HO,18,PL03,66880,66648,232,232,0
2021-04-09,HO,18,PL11,65272,65168,104,104,0
2021-09-02,CH,24,PL57,24616,24384,232,232,0
2021-01-04,DI,19,PL52,296928,296672,352,352,0
2021-04-25,HO,18,PL09,71920,71344,648,648,0
2021-02-23,PW,26,PL37,801408,799488,4224,4224,0
2021-08-14,SD,13,PL22,68585,68489,2990,2848,142
2021-09-03,HO,18,PL33,42496,42288,400,400,0
2021-07-23,RT,21,PL05,174168,172392,1968,1968,0
2021-01-28,HO,18,PL10,57184,57120,88,88,0
2021-01-08,HO,18,PL01,64200,63760,600,600,0
2021-04-07,RT,21,PL05,206976,206880,288,288,0
2021-05-10,SD,13,PL20,36535,36415,1436,1248,188
2021-01-19,SB,11,PL36,305856,303384,4032,4032,0
2021-12-01,RA,17,PL56,144432,143904,2016,2016,0
2021-10-21,HO,18,PL40,66136,66056,160,160,0
2021-05-20,RT,21,PL41,34544,29328,5216,5216,0
2021-06-25,PR,15,PL24,264256,263968,896,896,0
2021-10-21,RA,17,PL34,257256,256320,936,936,0
2021-05-18,DI,19,PL52,293024,291840,1472,1472,0
2021-01-19,PB,25,PL55,44512,27328,17184,17184,0
2021-01-19,CA,23,PL02,212592,201672,10920,10920,0
2021-10-26,RT,21,PL41,164176,160528,3648,3648,0
2021-02-24,SD,13,PL21,73620,73042,754,176,578
2021-05-19,DI,19,PL53,290592,288736,1856,1856,0
2021-04-08,PB,25,PL55,449728,449440,608,608,0
2021-07-25,SD,13,PL18,69279,69115,410,176,234
2021-04-28,HO,18,PL33,66224,66224,0,0,0
2021-09-02,HO,18,PL11,66288,66288,0,0,0
2021-06-14,PR,15,PL12,133216,132928,352,352,0
2021-11-20,SB,11,PL36,307416,305856,1728,1728,0
2021-08-27,CA,23,PL02,228792,227640,1632,1632,0
2021-01-08,NT,16,PL51,467968,466624,2176,2176,0
2021-11-01,RT,21,PL06,205104,201888,3432,3432,0
2021-01-15,DI,19,PL53,269952,266720,5312,5312,0
2021-10-15,SD,13,PL25,76286,75681,810,176,634
2021-03-10,HO,18,PL01,66208,65976,232,232,0
2021-07-18,SD,13,PL17,70420,68762,2063,400,1663
2021-08-16,PRG,12,PL14,391008,389280,2496,2496,0
2021-09-13,CA,23,PL02,110160,109512,648,648,0
2021-09-14,DI,19,PL52,121504,120512,3776,3776,0
2021-09-09,PR,15,PL04,320608,316160,5376,5376,0
2021-10-30,CA,23,PL02,129000,128184,912,912,0
2021-11-06,CL,14,PL45,275200,264256,9088,9088,0
2021-10-31,RA,17,PL34,43488,41328,2160,2160,0
2021-02-17,CL,14,PL44,239840,222624,3328,3328,0
2021-03-15,SD,13,PL25,70344,70246,946,832,114
2021-09-12,SD,13,PL18,69586,69218,943,560,383
2021-09-26,SD,13,PL20,74241,74183,234,176,58
2021-08-17,NT,16,PL51,155616,154080,1536,1536,0
2021-06-16,CH,24,PL57,34328,34288,40,40,0
2021-09-03,SD,13,PL19,72172,72153,620,512,108
2021-06-09,SD,13,PL25,58102,57148,2144,1184,960
2021-06-17,SD,13,PL21,73081,72434,1226,560,666
2021-07-22,CL,14,PL45,289024,282688,5344,5344,0
2021-07-04,CH,24,PL57,34244,34200,44,44,0
2021-08-10,RT,21,PL05,208728,208728,0,0,0
2021-08-07,SD,13,PL18,43908,43343,2205,1632,573
2021-09-20,HO,18,PL32,57112,56976,136,136,0
2021-10-18,CH,24,PL08,301837,299133,14059,11040,3019
2021-03-02,SB,11,PL36,263784,253656,10128,10128,0
2021-07-10,SD,13,PL19,65193,65161,384,352,32
2021-09-28,RT,21,PL05,169440,168912,528,528,0
2021-11-16,RT,21,PL42,185520,177360,8160,8160,0
2021-12-17,HO,18,PL11,66128,66032,168,168,0
2021-04-07,CA,23,PL02,216144,213360,2976,2976,0
2021-08-12,HO,18,PL09,72336,72256,104,104,0
2021-09-03,PR,15,PL04,353312,352992,1440,1440,0
2021-03-14,HO,18,PL32,67944,67848,96,96,0
2021-07-07,PRG,12,PL14,264896,263680,1600,1600,0
2021-11-07,CL,14,PL45,54688,50496,3584,3584,0
2021-12-17,SD,13,PL18,65592,65345,870,576,294
2021-02-25,EC,10,PL43,627264,627216,864,864,0
2021-06-25,PR,15,PL12,138992,139120,208,208,0
2021-08-14,SD,13,PL20,70560,70536,952,928,24
2021-03-26,PR,15,PL24,223296,223328,448,448,0
2021-07-09,PW,26,PL37,811728,805248,7440,7440,0
2021-08-07,SB,11,PL36,303120,300912,2568,2568,0
2021-06-09,PB,25,PL54,425216,423264,2784,2784,0
2021-03-14,PR,15,PL24,262880,262976,512,512,0
2021-11-19,DI,19,PL52,43008,43008,0,0,0
2021-09-30,SD,13,PL25,50605,49760,3049,1552,1497
2021-11-17,SD,13,PL20,75765,75673,547,384,163
2021-01-17,PR,15,PL24,264160,263904,1056,1056,0
2021-10-03,CA,23,PL13,85192,85280,208,208,0
2021-09-08,DI,19,PL53,298272,298432,0,0,0
2021-03-14,CA,23,PL31,232056,231912,480,480,0
2021-04-10,HO,18,PL10,56768,56736,96,96,0
2021-10-05,RT,21,PL05,40080,40008,11640,11640,0
2021-12-19,CH,24,PL07,62420,61677,1575,832,743
2021-08-18,RT,21,PL05,0,0,0,0,0
2021-10-13,RA,17,PL34,181440,176592,5112,5112,0
2021-01-30,DI,19,PL53,285632,284064,1760,1760,0
2021-08-05,CL,14,PL44,299904,296448,3456,3456,0
2021-10-30,PW,26,PL37,742224,726240,17472,17472,0
2021-01-31,CH,24,PL08,179128,160949,48963,30784,18179
2021-11-22,SD,13,PL20,80592,80432,336,176,160
2021-11-12,CL,14,PL44,299328,294496,3296,3296,0
2021-03-26,RT,21,PL05,135168,135168,0,0,0
2021-01-16,SB,11,PL50,449856,447424,3040,3040,0
2021-10-16,SD,13,PL20,74520,74404,194,0,194
2021-01-28,DI,19,PL53,295488,295328,384,384,0
2021-01-27,SD,13,PL20,0,0,0,0,0
2021-11-30,PR,15,PL04,267136,266944,352,352,0
2021-10-19,DI,19,PL53,293408,293280,896,896,0
2021-09-17,SD,13,PL17,69091,68740,374,0,374
2021-01-07,CA,23,PL13,79728,78080,1752,1752,0
2021-01-02,SB,11,PL36,210096,208848,1560,1560,0
2021-09-04,CA,23,PL02,228984,226608,2904,2904,0
2021-11-04,CL,14,PL45,276032,266624,8256,8256,0
2021-11-27,PW,26,PL37,810288,811392,1344,1344,0
2021-05-25,PW,26,PL37,624912,615024,11136,11136,0
2021-06-08,HO,18,PL30,66224,66224,0,0,0
2021-03-12,RT,21,PL05,202728,201840,1008,1008,0
2021-06-23,SD,13,PL22,75408,73855,1922,336,1586
2021-11-22,RT,21,PL05,132792,129456,3360,3360,0
2021-09-10,SD,13,PL25,74828,73129,1902,192,1710
2021-05-12,CL,14,PL45,211456,206912,6368,6368,0
2021-12-14,RA,17,PL56,259296,258984,624,624,0
2021-08-26,SD,13,PL18,47884,47615,634,208,426
2021-09-21,PR,15,PL24,267296,266624,672,672,0
2021-01-21,DI,19,PL53,257312,255456,3392,3392,0
2021-02-26,CH,24,PL08,220760,217348,11156,7744,3412
2021-06-18,PR,15,PL12,139184,139088,176,176,0
2021-01-18,RA,17,PL34,218952,218376,720,720,0
2021-04-16,SD,13,PL17,72748,71760,1164,176,988
2021-06-06,HO,18,PL01,67304,67048,256,256,0
2021-01-21,RA,17,PL34,173544,166752,6888,6888,0
2021-12-10,CH,24,PL12,165072,164752,320,320,0
2021-01-07,DI,19,PL53,298112,298560,0,0,0
2021-01-22,CA,23,PL31,209160,206304,3480,3480,0
2021-07-08,PR,15,PL24,267840,268000,0,0,0
2021-04-24,SD,13,PL17,71940,71563,1161,784,377
2021-09-22,CH,24,PL08,299144,296583,6230,3648,2582
2021-05-31,RA,17,PL34,219312,218184,1368,1368,0
2021-01-13,CL,14,PL44,248896,241728,928,928,0
2021-02-14,CH,24,PL07,224908,209995,17057,2144,14913
2021-06-10,HO,18,PL01,67264,66880,384,384,0
2021-04-27,RT,21,PL06,173208,170400,3048,3048,0
2021-06-01,HO,18,PL33,125488,125264,224,224,0
2021-03-25,PR,15,PL04,264352,264448,384,384,0
2021-02-22,SD,13,PL18,69227,68254,1630,592,1038
2021-03-01,HO,18,PL03,66224,66224,0,0,0
2021-07-19,HO,18,PL40,45424,43496,1928,1928,0
2021-09-16,SD,13,PL22,73824,73777,439,352,87
2021-12-10,CA,23,PL02,230952,229488,1992,1992,0
2021-04-15,RT,21,PL06,167904,165480,12456,12456,0
2021-09-14,RT,21,PL05,191904,187344,4560,4560,0
2021-02-22,CH,24,PL04,155392,155232,800,800,0
2021-08-24,SD,13,PL22,74746,74588,510,352,158
2021-09-09,CL,14,PL44,301408,296864,3808,3808,0
2021-04-30,SD,13,PL20,76338,76149,381,192,189
2021-06-26,RA,17,PL34,220344,220488,696,696,0
2021-01-31,CA,23,PL02,236376,234888,1848,1848,0
2021-07-02,SD,13,PL21,75608,75286,757,416,341
2021-05-03,SD,13,PL20,74916,74817,543,368,175
2021-06-09,PB,25,PL55,205408,205024,12704,12704,0
2021-03-24,RT,21,PL06,173136,170952,3984,3984,0
2021-04-07,CH,24,PL07,298080,292484,10022,4192,5830
2021-03-05,CA,23,PL13,85288,85224,136,136,0
2021-01-25,EC,10,PL43,609552,608064,1776,1776,0
2021-04-11,SD,13,PL17,71528,71336,906,688,218
2021-06-12,PR,15,PL12,138992,138400,736,736,0
2021-05-11,RA,17,PL34,179496,171672,8208,8208,0
2021-11-29,HO,18,PL30,115136,111648,3488,3488,0
2021-09-14,RT,21,PL42,126208,123024,3184,3184,0
2021-01-12,SD,13,PL20,51661,51182,1606,1120,486
2021-03-27,HO,18,PL11,60928,60752,352,352,0
2021-07-14,RT,21,PL42,186544,184320,2912,2912,0
2021-04-01,HO,18,PL30,66224,66224,0,0,0
2021-02-21,HO,18,PL33,65992,65632,360,360,0
2021-10-05,PB,25,PL55,448896,447776,2976,2976,0
2021-07-30,HO,18,PL11,40064,40048,120,120,0
2021-01-31,PRG,12,PL12,397696,397664,224,224,0
2021-09-14,CH,24,PL07,289620,270704,28950,9888,19062
2021-06-01,EC,10,PL43,10176,9984,15168,15168,0
2021-07-15,EC,10,PL43,578448,577008,1824,1824,0
2021-09-11,RT,21,PL42,190304,189968,2048,2048,0
2021-11-06,HO,18,PL32,56832,56744,88,88,0
2021-12-20,HO,18,PL10,68808,68496,312,312,0
2021-11-01,PRG,12,PL14,333472,329568,3904,3904,0
2021-12-07,SB,11,PL36,227496,225768,14352,14352,0
2021-05-26,RT,21,PL05,204480,203784,1008,1008,0
2021-12-19,CH,24,PL08,258468,251895,18045,11200,6845
2021-05-14,HO,18,PL09,56352,56264,232,232,0
2021-10-22,CA,23,PL31,229248,228120,1320,1320,0
2021-12-21,HO,18,PL30,87408,81824,5584,5584,0
2021-04-06,HO,18,PL30,65384,65208,280,280,0
2021-05-26,CL,14,PL45,236224,232352,4800,4800,0
2021-10-20,NT,16,PL51,507744,504160,4512,4512,0
2021-06-01,PR,15,PL04,266944,266304,768,768,0
2021-07-21,CA,23,PL31,229680,228264,2136,2136,0
2021-05-09,SD,13,PL22,73852,73525,1463,1136,327
2021-05-07,DI,19,PL53,295488,295456,352,352,0
2021-11-29,EC,10,PL43,379056,361344,18480,18480,0
2021-05-09,HO,18,PL33,65712,65664,88,88,0
2021-08-10,RA,17,PL34,221904,221544,360,360,0
2021-05-07,CL,14,PL45,135776,130912,2080,2080,0
2021-11-10,HO,18,PL01,65096,64816,280,280,0
2021-02-09,SD,13,PL20,66569,65293,2316,944,1372
2021-03-03,HO,18,PL32,66744,66032,712,712,0
2021-04-24,CA,23,PL02,233136,233352,456,456,0
2021-02-15,SD,13,PL25,72715,72657,634,576,58
2021-03-04,CL,14,PL45,290368,275360,4512,4512,0
2021-08-13,HO,18,PL09,72608,72520,88,88,0
2021-03-22,HO,18,PL10,55752,54784,992,992,0
2021-01-16,SD,13,PL25,71220,70982,462,224,238
2021-04-09,CL,14,PL45,300384,292288,1632,1632,0
2021-03-25,CH,24,PL12,148160,147792,880,880,0
2021-09-08,CL,14,PL44,238112,208384,4160,4160,0
2021-01-15,HO,18,PL30,66168,66160,0,0,0
2021-07-10,SD,13,PL17,64827,63455,1851,352,1499
2021-07-09,SD,13,PL17,44255,43624,1657,368,1289
2021-06-06,CL,14,PL45,1280,0,1280,1280,0
2021-09-26,CH,24,PL07,231511,223546,13597,5632,7965
2021-11-08,SB,11,PL50,450944,450144,2368,2368,0
2021-03-26,PB,25,PL54,80288,79680,608,608,0
2021-11-02,HO,18,PL09,45168,42664,2512,2512,0
2021-09-02,RT,21,PL42,173344,171440,1904,1904,0
2021-06-20,PR,15,PL12,139168,139168,256,256,0
2021-10-09,SB,11,PL36,251064,249288,1896,1896,0
2021-02-17,CH,24,PL04,162832,162352,848,848,0
2021-06-16,PR,15,PL04,264032,259552,5088,5088,0
2021-01-29,HO,18,PL03,66760,66512,280,280,0
2021-03-29,SD,13,PL25,51419,51394,1291,1248,43
2021-09-07,CA,23,PL02,232536,231024,1728,1728,0
2021-09-28,CH,24,PL12,164896,164640,256,256,0
2021-10-19,PB,25,PL55,203424,197600,96288,96288,0
2021-02-25,SB,11,PL50,451008,448544,3392,3392,0
2021-05-28,RT,21,PL06,202944,202824,648,648,0
2021-06-09,SD,13,PL20,0,0,1152,1152,0
2021-07-26,CL,14,PL45,282528,277408,4288,4288,0
2021-06-28,RT,21,PL06,207624,207768,288,288,0
2021-07-16,SD,13,PL25,1310,948,426,0,426
2021-01-11,PR,15,PL24,261184,257056,4128,4128,0
2021-02-11,CH,24,PL04,163616,163616,320,320,0
2021-06-02,SD,13,PL19,39990,39645,2158,1632,526
2021-05-24,HO,18,PL33,0,0,0,0,0
2021-09-29,HO,18,PL56,63632,63096,536,536,0
2021-07-25,HO,18,PL09,72432,72408,88,88,0
2021-03-15,NT,16,PL57,17456,16800,656,656,0
2021-06-25,SD,13,PL18,51829,51621,607,192,415
2021-03-03,RA,17,PL34,153120,153024,2304,2304,0
2021-02-11,CH,24,PL07,296159,287513,11964,3136,8828
2021-10-30,EC,10,PL43,493728,484416,9456,9456,0
2021-04-15,HO,18,PL01,64856,64792,168,168,0
2021-05-21,SB,11,PL36,272856,258696,14520,14520,0
2021-03-07,HO,18,PL11,64808,64712,272,272,0
2021-03-08,RT,21,PL42,183072,179776,3344,3344,0
2021-06-11,PB,25,PL54,443904,444384,832,832,0
2021-08-12,CA,23,PL02,189888,188304,2040,2040,0
2021-11-28,SD,13,PL18,72644,71218,1804,368,1436
2021-05-28,SB,11,PL50,456320,452960,4512,4512,0
2021-08-19,CA,23,PL13,67680,67576,104,104,0
2021-02-26,NT,16,PL57,149728,141552,8368,8368,0
2021-11-26,PR,15,PL04,212064,210464,1600,1600,0
2021-02-15,SD,13,PL17,72378,71803,781,192,589
2021-07-16,CA,23,PL31,209280,208632,1416,1416,0
2021-01-03,RA,17,PL35,220080,220056,384,384,0
2021-03-02,SD,13,PL22,8083,7962,13417,13296,121
2021-03-01,RT,21,PL41,19584,17424,2160,2160,0
2021-05-15,RT,21,PL42,184400,182128,2448,2448,0
2021-10-11,RA,17,PL34,159768,142680,17688,17688,0
2021-10-30,HO,18,PL40,32992,31360,1632,1632,0
2021-06-21,PRG,12,PL14,392000,391456,960,960,0
2021-08-05,PRG,12,PL14,0,0,5152,5152,0
2021-09-15,NT,16,PL51,512128,509216,2912,2912,0
2021-11-27,CA,23,PL13,14632,13888,760,760,0
2021-03-30,CL,14,PL44,291680,278592,3776,3776,0
2021-09-20,HO,18,PL33,132336,132416,0,0,0
2021-05-29,RA,17,PL34,220128,220056,360,360,0
2021-11-23,PB,25,PL55,159264,158944,8672,8672,0
2021-06-21,EC,10,PL43,631632,630816,1200,1200,0
2021-05-25,SB,11,PL50,362592,333792,29312,29312,0
2021-06-29,CA,23,PL11,228648,226968,2160,2160,0
2021-11-15,SD,13,PL22,75519,75346,525,352,173
2021-03-26,CA,23,PL02,74904,73248,1656,1656,0
2021-09-05,SB,11,PL36,166464,164808,1656,1656,0
2021-01-22,SD,13,PL21,72836,71072,1956,192,1764
2021-11-13,HO,18,PL32,48064,47768,288,288,0
2021-10-31,HO,18,PL32,56944,56744,200,200,0
2021-02-18,SD,13,PL17,38636,38349,479,192,287
2021-04-15,CH,24,PL08,159034,155877,10871,2528,8343
2021-04-07,PR,15,PL24,266592,265280,1504,1504,0
2021-05-08,PB,25,PL55,438912,438272,5856,5856,0
2021-06-12,PRG,12,PL14,395936,395936,224,224,0
2021-06-12,CA,23,PL02,233400,233688,432,432,0
2021-09-02,CH,24,PL07,308845,303870,12655,7680,4975
2021-10-01,RT,21,PL42,62544,60288,23584,23584,0
2021-07-12,CA,23,PL31,96024,95064,1488,1488,0
2021-10-17,SD,13,PL25,61601,60838,1115,352,763
2021-11-11,RT,21,PL41,173600,165888,7712,7712,0
2021-03-31,SD,13,PL21,65029,64807,424,176,248
2021-05-18,RA,17,PL56,155976,154320,1656,1656,0
2021-11-14,CA,23,PL31,158904,156432,2472,2472,0
2021-01-06,HO,18,PL03,66384,66408,128,128,0
2021-10-05,CH,24,PL57,34124,34112,44,44,0
2021-06-04,SD,13,PL18,67423,65605,5162,3344,1818
2021-03-03,SD,13,PL20,68952,68601,1887,1536,351
2021-06-16,SD,13,PL22,14951,14336,2659,2032,627
2021-03-18,SD,13,PL21,73370,72556,968,112,856
2021-01-20,CA,23,PL13,85392,85400,120,120,0
2021-03-04,PW,26,PL37,429648,426192,46464,46464,0
2021-10-08,HO,18,PL32,56856,56712,288,288,0
2021-03-08,NT,16,PL51,8064,8032,32,32,0
2021-06-25,PB,25,PL55,436320,425600,12928,12928,0
2021-01-09,CA,23,PL13,84672,82544,2200,2200,0
2021-10-28,HO,18,PL01,67088,65904,1184,1184,0
2021-07-14,HO,18,PL33,66120,66168,0,0,0
2021-01-28,DI,19,PL52,281600,281504,1344,1344,0
2021-07-28,HO,18,PL56,0,0,14632,14632,0
2021-02-25,PR,15,PL24,263584,263072,832,832,0
2021-02-24,PB,25,PL55,416864,413440,4256,4256,0
2021-03-22,RT,21,PL05,206064,205296,1056,1056,0
2021-09-12,HO,18,PL33,110352,109472,1136,1136,0
2021-02-05,PR,15,PL24,260960,252480,8480,8480,0
2021-09-05,CL,14,PL44,204160,201120,2176,2176,0
2021-04-06,HO,18,PL33,66224,66224,0,0,0
2021-03-09,SD,13,PL22,69161,68898,295,32,263
2021-09-19,CH,24,PL57,34252,34200,48,48,0
2021-07-19,SD,13,PL20,76331,76278,229,176,53
2021-01-28,RT,21,PL05,173712,173160,792,792,0
2021-04-12,HO,18,PL33,56120,55776,344,344,0
2021-10-21,HO,18,PL09,65512,65224,352,352,0
2021-05-21,CH,24,PL07,251175,243912,11474,4128,7346
2021-08-18,SD,13,PL22,0,0,0,0,0
2021-03-09,HO,18,PL11,66288,66272,16,16,0
2021-03-18,NT,16,PL57,67264,65360,1904,1904,0
2021-10-21,PRG,12,PL14,390912,390560,992,992,0
2021-05-03,RT,21,PL05,206616,206568,264,264,0
2021-06-24,SD,13,PL17,75917,75223,870,176,694
2021-12-02,SD,13,PL22,65735,65677,2202,2144,58
2021-03-10,DI,19,PL53,3744,3392,352,352,0
2021-09-27,DI,19,PL52,288544,287808,1312,1312,0
2021-07-08,PR,15,PL12,0,0,1808,1808,0
2021-05-30,SD,13,PL25,72220,71694,921,368,553
2021-04-08,PR,15,PL04,265120,265024,448,448,0
2021-08-08,RA,17,PL34,221112,220728,648,648,0
2021-11-18,RT,21,PL41,171936,158992,14240,14240,0
2021-10-11,CA,23,PL31,10584,10272,1608,1608,0
2021-02-24,NT,16,PL57,90192,84048,6144,6144,0
2021-05-26,HO,18,PL32,67872,67624,248,248,0
2021-01-13,RA,17,PL35,223416,223416,0,0,0
2021-06-17,HO,18,PL30,64512,64328,184,184,0
2021-10-21,RT,21,PL41,111328,109184,2144,2144,0
2021-10-09,RT,21,PL41,5568,3376,2192,2192,0
2021-05-31,RA,17,PL56,219072,218760,576,576,0
2021-08-13,PB,25,PL54,446112,445248,1312,1312,0
2021-07-26,SD,13,PL17,61952,60773,2139,960,1179
2021-09-30,CA,23,PL13,85424,85432,96,96,0
2021-12-11,RT,21,PL42,20032,0,20032,20032,0
2021-02-26,PB,25,PL55,448544,449184,576,576,0
2021-02-10,HO,18,PL11,66048,65896,152,152,0
2021-02-04,SD,13,PL25,5012,5005,7,0,7
2021-03-10,RT,21,PL41,9344,0,9344,9344,0
2021-03-17,SD,13,PL20,76042,75740,510,192,318
2021-02-22,HO,18,PL33,67056,67072,424,424,0
2021-09-23,RT,21,PL42,183120,180416,2832,2832,0
2021-07-03,SD,13,PL18,69483,68956,756,176,580
2021-08-05,HO,18,PL10,69240,69240,0,0,0
2021-08-03,CL,14,PL45,165792,144928,10944,10944,0
2021-06-06,CH,24,PL07,117106,107417,11409,1632,9777
2021-10-04,PB,25,PL54,207424,184896,22528,22528,0
2021-05-25,DI,19,PL52,279328,277888,1600,1600,0
2021-02-20,RT,21,PL06,205968,205776,264,264,0
2021-04-12,CH,24,PL07,281508,276978,10538,5568,4970
2021-04-13,CA,23,PL13,85160,84992,344,344,0
2021-01-21,HO,18,PL30,66160,66160,0,0,0
2021-07-15,SD,13,PL20,4370,4367,3,0,3
2021-05-03,RT,21,PL42,163984,124656,39536,39536,0
2021-04-30,HO,18,PL30,66224,66224,0,0,0
2021-05-26,RT,21,PL42,181808,180048,1760,1760,0
2021-02-14,PR,15,PL57,142000,141872,176,176,0
2021-01-25,SB,11,PL36,311736,310128,1608,1608,0
2021-02-21,RA,17,PL56,219264,218832,552,552,0
2021-02-20,RT,21,PL42,98528,97600,928,928,0
2021-11-19,PRG,12,PL14,19040,18400,0,0,0
2021-07-22,SD,13,PL25,23924,23717,1720,1504,216
2021-06-19,SB,11,PL36,301152,296208,5136,5136,0
2021-11-02,SD,13,PL18,76320,75713,1199,592,607
2021-10-08,CH,24,PL07,266012,260323,17817,12128,5689
2021-11-03,SD,13,PL19,76353,76262,283,192,91
2021-05-11,CA,23,PL31,233712,232776,1392,1392,0
2021-02-03,PR,15,PL57,0,0,464,464,0
2021-11-28,HO,18,PL01,67608,67360,296,296,0
2021-06-21,DI,19,PL53,264992,263744,2176,2176,0
2021-03-28,HO,18,PL32,67680,67592,88,88,0
2021-07-04,SD,13,PL20,75878,75863,272,208,64
2021-07-20,HO,18,PL01,67640,67464,208,208,0
2021-12-09,CA,23,PL13,83872,83752,352,352,0
2021-06-02,CH,24,PL07,289782,277868,18031,4512,13519
2021-10-29,SD,13,PL18,24696,24567,338,208,130
2021-12-06,EC,10,PL43,626928,625872,816,816,0
2021-02-25,PRG,12,PL14,392544,392000,800,800,0
2021-03-20,CL,14,PL44,267680,259360,3808,3808,0
2021-08-01,CL,14,PL45,272928,230112,9664,9664,0
2021-10-27,CA,23,PL02,232224,229896,2736,2736,0
2021-05-04,HO,18,PL40,67480,67392,88,88,0
2021-12-08,CA,23,PL02,230328,229032,2520,2520,0
2021-04-19,CH,24,PL08,171525,165605,10419,4160,6259
2021-04-09,CH,24,PL07,277411,272509,10826,5632,5194
2021-07-25,PB,25,PL54,423392,420288,3328,3328,0
2021-11-09,HO,18,PL09,66248,66080,416,416,0
2021-04-28,SB,11,PL50,380128,380064,1696,1696,0
2021-09-14,HO,18,PL56,65096,64792,304,304,0
2021-03-30,CA,23,PL31,171048,169224,3144,3144,0
2021-05-17,CA,23,PL13,84992,84888,200,200,0
2021-01-19,HO,18,PL32,17408,16768,640,640,0
2021-08-15,SD,13,PL25,76216,75760,659,176,483
2021-06-30,PR,15,PL04,267328,263488,4128,4128,0
2021-10-11,SD,13,PL22,76341,76359,227,176,51
2021-03-24,SD,13,PL25,73930,73881,235,176,59
2021-09-30,CA,23,PL02,8592,0,8592,8592,0
2021-10-20,HO,18,PL32,26360,26264,408,408,0
2021-03-11,PW,26,PL37,812640,810576,2832,2832,0
2021-09-16,PB,25,PL54,0,0,36960,36960,0
2021-01-18,RT,21,PL06,115008,114312,1440,1440,0
2021-02-03,RA,17,PL56,156144,153600,2832,2832,0
2021-10-18,HO,18,PL01,60344,59672,672,672,0
2021-05-12,HO,18,PL09,68752,68648,128,128,0
2021-09-17,HO,18,PL03,66824,66800,88,88,0
2021-12-13,DI,19,PL52,294304,292704,1792,1792,0
2021-11-04,PR,15,PL04,0,0,8288,8288,0
2021-02-01,CL,14,PL45,299072,289536,2144,2144,0
2021-01-03,DI,19,PL52,298944,299392,0,0,0
2021-08-17,HO,18,PL56,22600,22600,0,0,0
2021-08-04,RA,17,PL34,216432,214032,2400,2400,0
2021-10-12,SB,11,PL50,388544,387104,2240,2240,0
2021-05-14,PB,25,PL54,438912,434944,4960,4960,0
2021-09-27,SD,13,PL21,58973,58629,1992,1648,344
2021-05-28,SD,13,PL25,63175,62390,1889,1104,785
2021-09-10,CL,14,PL44,298912,296800,2176,2176,0
2021-08-03,SD,13,PL20,75187,75127,398,320,78
2021-01-10,DI,19,PL52,299168,298560,704,704,0
2021-09-30,SD,13,PL21,65319,64956,397,16,381
2021-04-14,EC,10,PL43,431280,426192,4704,4704,0
2021-04-30,RA,17,PL35,205896,202272,3624,3624,0
2021-07-12,RT,21,PL42,180832,179632,1200,1200,0
2021-06-03,SB,11,PL50,360096,356224,4736,4736,0
2021-10-12,HO,18,PL33,132528,132528,0,0,0
2021-04-28,PRG,12,PL14,391008,390400,1056,1056,0
2021-11-07,SD,13,PL18,74753,74264,1257,768,489
2021-01-05,RT,21,PL06,203256,202512,840,840,0
2021-07-21,HO,18,PL40,64184,63656,600,600,0
2021-01-18,SD,13,PL22,71081,70380,909,208,701
2021-03-22,RT,21,PL06,206280,205872,888,888,0
2021-09-18,PW,26,PL37,812496,812352,2784,2784,0
2021-10-26,CA,23,PL31,5520,5808,5160,5160,0
2021-05-01,PRG,12,PL14,311904,311040,864,864,0
2021-03-10,PB,25,PL55,261632,245408,16896,16896,0
2021-05-09,CH,24,PL12,163632,163696,320,320,0
2021-06-14,SD,13,PL18,72819,72844,1987,1840,147
2021-06-22,PB,25,PL54,403072,401984,1184,1184,0
2021-07-05,CA,23,PL02,190488,190728,480,480,0
2021-08-04,CA,23,PL31,234768,234192,792,792,0
2021-12-17,CH,24,PL07,272645,268340,10193,5888,4305
2021-10-01,DI,19,PL52,226720,222976,4064,4064,0
2021-03-08,RT,21,PL41,25456,11872,13584,13584,0
2021-04-11,CL,14,PL44,194016,184256,6176,6176,0
2021-08-31,SD,13,PL17,53669,53534,327,192,135
2021-03-09,CL,14,PL45,285600,277728,4032,4032,0
2021-07-09,CH,24,PL08,300193,293437,17759,10912,6847
2021-09-23,SD,13,PL19,64001,63885,1591,1456,135
2021-02-05,RT,21,PL05,204912,203760,1296,1296,0
2021-12-04,CH,24,PL57,34108,34100,52,52,0
2021-12-10,CA,23,PL31,121056,117912,3504,3504,0
2021-06-24,DI,19,PL52,289728,289440,448,448,0
2021-09-05,SB,11,PL50,456736,454944,2368,2368,0
2021-11-07,SD,13,PL25,67170,66337,1205,320,885
2021-04-03,HO,18,PL09,38784,38040,784,784,0
2021-10-07,CH,24,PL12,90272,88976,1968,1968,0
2021-12-07,SB,11,PL50,461696,460928,1056,1056,0
2021-02-08,PW,26,PL37,426240,412512,14064,14064,0
2021-11-23,PR,15,PL04,264960,264256,832,832,0
2021-05-21,RA,17,PL34,213840,213480,672,672,0
2021-06-19,CH,24,PL57,33048,32916,132,132,0
2021-09-10,DI,19,PL52,294688,290144,4928,4928,0
2021-01-21,SB,11,PL50,17312,0,37216,37216,0
2021-04-13,SD,13,PL19,74990,74821,537,368,169
2021-09-22,RT,21,PL41,166384,151920,14528,14528,0
2021-08-23,CA,23,PL02,186888,187224,864,864,0
2021-08-11,PB,25,PL54,411104,401216,10368,10368,0
2021-10-17,SD,13,PL18,70138,69336,1053,192,861
2021-06-20,PW,26,PL37,815424,814032,2880,2880,0
2021-09-01,CL,14,PL44,200064,198336,1344,1344,0
2021-06-03,SB,11,PL36,305760,304824,1944,1944,0
2021-02-02,CH,24,PL04,164544,164272,416,416,0
2021-08-17,SD,13,PL20,17877,17871,534,528,6
2021-03-11,CH,24,PL07,304501,296462,12172,4032,8140
2021-08-19,SD,13,PL20,65013,65071,2726,2672,54
2021-11-27,SD,13,PL19,64970,64882,88,0,88
2021-10-12,RT,21,PL05,180120,173592,6576,6576,0
2021-11-26,HO,18,PL33,61112,60656,520,520,0
2021-12-15,RA,17,PL56,257496,257232,528,528,0
2021-11-06,RT,21,PL05,203784,202848,1056,1056,0
2021-11-29,SB,11,PL36,179424,163008,16416,16416,0
2021-04-26,EC,10,PL43,0,0,11584,11584,0
2021-10-14,CL,14,PL45,0,0,8192,8192,0
2021-07-17,PRG,12,PL14,390048,389696,1088,1088,0
2021-06-26,PB,25,PL55,445376,445376,1024,1024,0
2021-08-06,HO,18,PL40,65440,65008,432,432,0
2021-09-21,PW,26,PL37,775008,761232,14544,14544,0
2021-02-28,CH,24,PL04,165056,164896,240,240,0
2021-05-07,RT,21,PL42,179216,175808,3984,3984,0
2021-06-11,PRG,12,PL14,393504,393184,832,832,0
2021-02-09,PRG,12,PL14,367456,366496,1504,1504,0
2021-06-10,SD,13,PL18,61523,60059,2008,544,1464
2021-06-10,PR,15,PL04,266912,262848,4128,4128,0
2021-06-07,EC,10,PL43,592800,585456,5184,5184,0
2021-09-19,HO,18,PL03,66928,66648,312,312,0
2021-04-30,PB,25,PL54,85088,85216,96,96,0
2021-01-06,CH,24,PL08,303095,293448,16591,6944,9647
2021-03-17,RA,17,PL56,219336,216696,2856,2856,0
2021-03-26,CA,23,PL13,49640,48632,992,992,0
2021-11-26,CA,23,PL13,85128,84824,376,376,0
2021-09-06,CH,24,PL12,151152,149856,1296,1296,0
2021-04-27,CA,23,PL11,218928,215688,3456,3456,0
2021-04-28,DI,19,PL52,252992,253632,0,0,0
2021-09-19,CL,14,PL44,304160,301408,2144,2144,0
2021-10-25,CH,24,PL12,140592,140368,560,560,0
2021-09-29,SB,11,PL36,243024,228624,14400,14400,0
2021-06-27,RA,17,PL34,224448,224088,312,312,0
2021-12-23,PR,15,PL04,5792,5440,352,352,0
2021-04-11,CH,24,PL12,162896,162688,496,496,0
2021-02-20,CH,24,PL04,163408,162896,640,640,0
2021-06-02,CH,24,PL57,33268,33168,164,164,0
2021-05-19,SD,13,PL25,71529,71137,568,176,392
2021-08-07,HO,18,PL10,68624,68544,104,104,0
2021-07-11,HO,18,PL09,71656,71736,120,120,0
2021-10-29,SD,13,PL20,22655,22614,41,0,41
2021-04-24,SD,13,PL18,53822,53518,3547,3168,379
2021-06-28,RT,21,PL05,189672,188568,1992,1992,0
2021-07-12,EC,10,PL43,625680,625008,1872,1872,0
2021-11-09,RT,21,PL05,17760,17712,48,48,0
2021-02-15,PW,26,PL37,807792,807984,1824,1824,0
2021-03-31,CL,14,PL44,241120,237312,1440,1440,0
2021-06-06,DI,19,PL53,295136,294048,1280,1280,0
2021-06-24,SD,13,PL18,75783,75350,1249,816,433
2021-03-07,CA,23,PL31,219888,217992,2280,2280,0
2021-07-17,CA,23,PL31,228264,227280,1296,1296,0
2021-10-05,CH,24,PL07,139949,136304,18782,13664,5118
2021-03-06,RA,17,PL56,219816,219240,576,576,0
2021-05-04,SD,13,PL17,71726,71344,964,576,388
2021-04-24,PB,25,PL54,416384,369344,47520,47520,0
2021-04-04,HO,18,PL01,64656,64400,256,256,0
2021-09-20,HO,18,PL03,66208,65920,360,360,0
2021-05-20,SD,13,PL22,71149,70154,1555,560,995
2021-11-13,SD,13,PL25,72605,71343,1443,176,1267
2021-11-29,RA,17,PL56,0,0,3912,3912,0
2021-03-19,SD,13,PL25,70540,70329,665,400,265
2021-05-15,PR,15,PL04,247456,247040,4832,4832,0
2021-07-04,SD,13,PL25,73829,73102,1303,576,727
2021-03-15,DI,19,PL53,295808,294848,1056,1056,0
2021-02-04,SD,13,PL18,66709,65968,1382,640,742
2021-08-14,CH,24,PL57,34232,34188,44,44,0
2021-11-28,RT,21,PL05,59400,59064,336,336,0
2021-02-02,RT,21,PL41,33952,26368,7584,7584,0
2021-03-17,RT,21,PL42,188912,177152,11760,11760,0
2021-09-23,HO,18,PL03,66688,66688,88,88,0
2021-12-06,CA,23,PL13,83208,82936,560,560,0
2021-11-04,RT,21,PL05,164616,163992,2832,2832,0
2021-06-04,SD,13,PL20,76571,75599,1148,176,972
2021-11-18,CL,14,PL45,279264,274112,4160,4160,0
2021-11-09,CL,14,PL44,289696,280800,8480,8480,0
2021-03-11,RT,21,PL42,184512,178848,6208,6208,0
2021-10-12,HO,18,PL01,65848,65616,480,480,0
2021-12-03,RA,17,PL34,230808,229584,1656,1656,0
2021-04-11,SD,13,PL19,75940,75999,616,576,40
2021-06-30,HO,18,PL33,131936,131936,0,0,0
2021-06-03,CH,24,PL07,321214,312795,10710,1824,8886
2021-02-13,SB,11,PL36,311832,310944,1200,1200,0
2021-07-04,SD,13,PL22,76409,76324,261,176,85
2021-03-08,EC,10,PL43,440976,439872,6096,6096,0
2021-08-25,SD,13,PL21,21514,16983,14931,10400,4531
2021-11-01,SB,11,PL36,229272,225168,4608,4608,0
2021-03-15,RT,21,PL42,179184,161104,18352,18352,0
2021-02-19,SD,13,PL22,69670,68667,1775,784,991
2021-02-18,SD,13,PL25,53534,53499,2942,2816,126
2021-05-16,SD,13,PL21,66832,66328,745,176,569
2021-08-19,CH,24,PL12,131104,130704,432,432,0
2021-01-15,SD,13,PL17,58316,58253,973,896,77
2021-11-20,CH,24,PL24,161568,161088,832,832,0
2021-11-21,SD,13,PL25,17471,17437,414,336,78
2021-06-02,SB,11,PL50,304256,302496,4480,4480,0
2021-02-16,HO,18,PL11,57864,57160,704,704,0
2021-10-28,CH,24,PL08,157377,153106,5931,1312,4619
2021-10-02,HO,18,PL33,132368,132432,0,0,0
2021-07-02,CH,24,PL08,262334,251537,18612,7808,10804
2021-02-26,PR,15,PL24,263872,257504,6528,6528,0
2021-06-03,RA,17,PL56,107712,102528,5232,5232,0
2021-03-20,RA,17,PL56,198192,190848,7344,7344,0
2021-10-05,HO,18,PL03,55560,55328,288,288,0
2021-06-20,SD,13,PL18,74490,73821,1703,1008,695
2021-08-07,CA,23,PL31,0,0,0,0,0
2021-04-14,DI,19,PL53,259008,258144,2400,2400,0
2021-12-16,RT,21,PL41,13104,176,12928,12928,0
2021-01-05,SD,13,PL22,70290,70251,407,368,39
2021-10-19,SB,11,PL36,283248,266016,17928,17928,0
2021-05-07,SD,13,PL17,61669,61342,1095,768,327
2021-05-18,SD,13,PL17,70341,69970,1299,928,371
2021-07-24,SD,13,PL20,44478,44415,1327,1264,63
2021-06-26,PR,15,PL12,139504,139424,224,224,0
2021-07-05,CL,14,PL45,295072,282592,4224,4224,0
2021-07-04,CA,23,PL11,229248,228168,1368,1368,0
2021-07-02,DI,19,PL53,292608,290848,2048,2048,0
2021-09-12,CA,23,PL31,107544,105456,2088,2088,0
2021-08-27,HO,18,PL11,66296,66296,0,0,0
2021-04-24,DI,19,PL52,289920,288672,1664,1664,0
2021-10-16,CH,24,PL12,157824,157328,496,496,0
2021-05-30,RA,17,PL56,220536,219984,552,552,0
2021-09-29,PW,26,PL37,795840,794784,2640,2640,0
2021-01-24,PR,15,PL04,262784,261184,2112,2112,0
2021-04-22,SD,13,PL18,65435,65151,3533,3152,381
2021-05-16,HO,18,PL03,61272,61352,0,0,0
2021-05-31,HO,18,PL40,63344,62952,432,432,0
2021-12-02,CH,24,PL12,163712,163632,192,192,0
2021-02-27,SD,13,PL17,71593,71505,280,192,88
2021-05-15,CL,14,PL45,263488,256640,6752,6752,0
2021-10-03,NT,16,PL51,401888,401344,1248,1248,0
2021-03-03,CA,23,PL31,225120,214752,10848,10848,0
2021-06-08,PB,25,PL54,372512,370208,4128,4128,0
2021-05-02,PB,25,PL54,307296,307424,7936,7936,0
2021-07-25,HO,18,PL03,67024,66056,968,968,0
2021-09-07,DI,19,PL53,294976,294848,608,608,0
2021-01-28,SD,13,PL25,48720,46977,10592,8832,1760
2021-11-04,HO,18,PL03,66624,66560,200,200,0
2021-07-01,PRG,12,PL14,390144,389408,1312,1312,0
2021-03-07,DI,19,PL53,293088,292768,1056,1056,0
2021-07-26,RA,17,PL34,0,0,648,648,0
2021-09-22,CA,23,PL31,234768,234288,696,696,0
2021-06-28,PW,26,PL37,806784,806448,2928,2928,0
2021-11-20,HO,18,PL33,47192,46968,224,224,0
2021-03-12,DI,19,PL53,281888,280768,1440,1440,0
2021-12-02,SD,13,PL25,62659,61876,998,176,822
2021-02-01,HO,18,PL11,63112,62880,232,232,0
2021-02-21,PW,26,PL37,808848,806400,3456,3456,0
2021-05-16,SD,13,PL22,67308,66548,1217,368,849
2021-05-27,PRG,12,PL14,391392,390912,1120,1120,0
2021-11-25,DI,19,PL52,295360,295168,448,448,0
2021-12-22,CA,23,PL35,77136,77048,88,88,0
2021-06-18,NT,16,PL51,454848,450048,5440,5440,0
2021-02-25,HO,18,PL10,57616,57664,0,0,0
2021-07-10,RT,21,PL05,208272,208536,0,0,0
2021-07-26,SD,13,PL18,40949,39982,3831,2864,967
2021-09-26,CH,24,PL12,163520,163600,320,320,0
2021-04-29,RT,21,PL06,203808,203712,360,360,0
2021-10-06,CL,14,PL44,249152,241248,3168,3168,0
2021-04-14,HO,18,PL30,66224,66224,0,0,0
2021-10-12,SD,13,PL18,74064,73842,627,352,275
2021-12-04,CL,14,PL45,113920,112864,192,192,0
2021-03-29,RA,17,PL56,182160,175224,7176,7176,0
2021-09-14,SD,13,PL19,75313,75314,417,368,49
2021-02-13,CA,23,PL13,85304,85304,152,152,0
2021-09-18,CH,24,PL12,164560,164080,496,496,0
2021-05-08,CH,24,PL12,163440,163360,224,224,0
2021-05-29,CL,14,PL44,294112,289376,4128,4128,0
2021-03-08,HO,18,PL10,50656,47832,2856,2856,0
2021-07-29,SD,13,PL18,66657,66219,1645,1200,445
2021-06-27,EC,10,PL43,564192,561600,2832,2832,0
2021-08-08,SD,13,PL25,75871,74559,1541,176,1365
2021-04-30,HO,18,PL32,67760,67672,88,88,0
2021-10-20,HO,18,PL01,65232,64352,1016,1016,0
2021-05-17,CA,23,PL02,175368,168504,7056,7056,0
2021-05-22,PRG,12,PL14,370144,369632,1024,1024,0
2021-07-21,PRG,12,PL14,142400,142304,96,96,0
2021-05-10,RA,17,PL56,200736,200016,1152,1152,0
2021-06-26,SD,13,PL22,76683,76215,468,0,468
2021-02-16,CH,24,PL08,124224,123296,2144,2144,0
2021-11-30,CA,23,PL02,189312,188904,1344,1344,0
2021-05-19,HO,18,PL03,64944,64512,432,432,0
2021-10-07,PR,15,PL04,257088,251776,5440,5440,0
2021-01-16,PRG,12,PL12,393568,393952,768,768,0
2021-10-05,PW,26,PL37,812208,811344,6048,6048,0
2021-06-08,CL,14,PL44,111040,53376,2912,2912,0
2021-03-13,CH,24,PL08,162776,158566,16114,11904,4210
2021-08-09,SD,13,PL25,69163,68052,1866,688,1178
2021-11-21,SD,13,PL22,75962,75941,642,608,34
2021-04-21,SD,13,PL18,74367,74237,306,176,130
2021-12-21,SD,13,PL17,76146,75504,818,176,642
2021-10-04,SD,13,PL22,76098,76158,241,192,49
2021-01-15,EC,10,PL43,621504,619920,1392,1392,0
2021-10-29,RT,21,PL05,42792,42144,648,648,0
2021-08-06,PR,15,PL12,139328,139312,176,176,0
2021-10-29,SD,13,PL22,18765,18712,437,384,53
2021-01-11,RA,17,PL35,217656,213072,4584,4584,0
2021-02-08,SD,13,PL18,73343,72520,1591,768,823
2021-06-28,HO,18,PL32,68600,68600,0,0,0
2021-04-15,SD,13,PL19,76040,76005,35,0,35
2021-06-04,CA,23,PL13,75656,74680,1048,1048,0
2021-02-12,PRG,12,PL12,393760,393344,960,960,0
2021-11-12,CH,24,PL24,163616,163648,240,240,0
2021-06-24,CH,24,PL07,311857,296454,18282,2784,15498
2021-09-05,RA,17,PL34,206544,201624,4920,4920,0
2021-10-22,SD,13,PL20,71810,71709,928,736,192
2021-09-02,CL,14,PL45,218400,205472,6592,6592,0
2021-03-07,HO,18,PL01,66152,65912,240,240,0
2021-04-12,SD,13,PL17,5988,5978,442,432,10
2021-09-02,PRG,12,PL14,389536,388032,3552,3552,0
2021-10-04,SD,13,PL25,75974,75457,656,0,656
2021-05-16,CH,24,PL07,276362,259581,18485,1632,16853
2021-05-04,HO,18,PL03,66208,66280,0,0,0
2021-07-17,PB,25,PL54,437728,437088,1536,1536,0
2021-12-02,HO,18,PL09,66144,66024,120,120,0
2021-09-14,PB,25,PL55,434752,418624,16960,16960,0
2021-04-12,SD,13,PL25,36646,36423,2012,1360,652
2021-09-08,CH,24,PL12,163120,161104,2192,2192,0
2021-07-19,SD,13,PL19,60259,60242,401,368,33
2021-04-30,NT,16,PL51,458560,457760,1344,1344,0
2021-10-27,RT,21,PL41,177936,172256,5760,5760,0
2021-10-19,CL,14,PL44,301792,300064,1248,1248,0
2021-04-28,EC,10,PL43,0,0,560,560,0
2021-12-02,SD,13,PL17,61674,60988,862,176,686
2021-04-24,CA,23,PL11,232536,229608,3408,3408,0
2021-12-17,HO,18,PL10,68328,68232,96,96,0
2021-07-20,HO,18,PL56,66144,65976,168,168,0
2021-11-11,EC,10,PL43,621216,620016,1056,1056,0
2021-01-06,PRG,12,PL14,392032,390464,1568,1568,0
2021-03-01,RA,17,PL35,213072,211200,2016,2016,0
2021-05-22,RA,17,PL35,205752,205008,864,864,0
2021-06-15,PR,15,PL12,139760,139712,176,176,0
2021-09-24,CA,23,PL02,141192,139320,1920,1920,0
2021-04-14,RT,21,PL05,207576,207240,528,528,0
2021-06-02,CL,14,PL45,291648,284448,4416,4416,0
2021-03-24,CH,24,PL08,312038,278357,38864,5024,33840
2021-05-06,PB,25,PL55,414336,393920,20736,20736,0
2021-08-21,SD,13,PL20,75292,75282,588,560,28
2021-03-09,RA,17,PL35,171264,169656,1728,1728,0
2021-10-16,SD,13,PL25,28902,28634,652,384,268
2021-05-19,HO,18,PL40,67752,67552,200,200,0
2021-08-11,SD,13,PL17,72226,71193,1881,848,1033
2021-09-13,HO,18,PL10,67888,67744,192,192,0
2021-08-03,RT,21,PL05,172248,172224,816,816,0
2021-05-04,RT,21,PL05,178464,178680,816,816,0
2021-06-06,PB,25,PL55,368800,364640,4480,4480,0
2021-09-10,CH,24,PL07,102970,94056,10078,992,9086
2021-05-15,CH,24,PL07,264031,255295,17514,8608,8906
2021-12-12,PR,15,PL24,261664,261504,416,416,0
2021-01-11,PRG,12,PL14,334848,334432,416,416,0
2021-05-09,RT,21,PL05,206256,206232,360,360,0
2021-04-14,HO,18,PL01,66088,65944,200,200,0
2021-06-26,NT,16,PL51,509472,508416,2016,2016,0
2021-03-14,HO,18,PL09,67144,67192,240,240,0
2021-03-01,CH,24,PL12,162016,162000,512,512,0
2021-01-11,RT,21,PL06,180048,176568,6360,6360,0
2021-08-04,HO,18,PL01,50704,49640,1064,1064,0
2021-09-18,CH,24,PL07,47767,40653,11991,2848,9143
2021-12-20,CH,24,PL07,256405,252000,8245,3840,4405
2021-06-20,DI,19,PL52,207008,203296,4256,4256,0
2021-07-14,PB,25,PL54,432288,330080,102912,102912,0
2021-06-03,SD,13,PL18,61837,60249,2201,592,1609
2021-11-24,SD,13,PL19,65115,65052,273,176,97
2021-07-27,CL,14,PL45,118720,111168,6656,6656,0
2021-09-24,CH,24,PL12,164512,164272,240,240,0
2021-11-12,CL,14,PL45,285376,276128,6528,6528,0
2021-03-13,CH,24,PL07,307034,294885,13525,1376,12149
2021-11-27,RT,21,PL05,206304,206256,264,264,0
2021-11-30,EC,10,PL43,515520,497424,18576,18576,0
2021-05-03,EC,10,PL43,119136,104080,15120,15120,0
2021-06-07,DI,19,PL52,293728,293664,800,800,0
2021-09-19,SD,13,PL22,55767,55826,594,368,226
2021-11-04,CH,24,PL07,311288,308179,8229,5120,3109
2021-08-18,PR,15,PL24,0,0,0,0,0
2021-02-04,HO,18,PL03,32248,28376,3872,3872,0
2021-12-13,HO,18,PL09,62368,62096,272,272,0
2021-06-29,PR,15,PL24,264768,264768,416,416,0
2021-04-19,RT,21,PL06,113280,113208,360,360,0
2021-06-25,EC,10,PL43,616656,613824,3504,3504,0
2021-06-30,NT,16,PL51,505440,504448,1632,1632,0
2021-07-01,PW,26,PL37,113424,111264,3984,3984,0
2021-02-04,CL,14,PL44,308512,303840,864,864,0
2021-07-20,SD,13,PL22,76214,75984,406,176,230
2021-08-26,CA,23,PL02,215880,214560,1416,1416,0
2021-05-22,PB,25,PL54,418912,410752,9408,9408,0
2021-05-03,HO,18,PL30,66224,66224,0,0,0
2021-06-07,CH,24,PL07,286422,272261,19769,5280,14489
2021-06-23,SD,13,PL25,71705,71066,1103,448,655
2021-08-06,HO,18,PL30,66216,66232,0,0,0
2021-04-09,PB,25,PL55,388448,376288,12928,12928,0
2021-01-17,SD,13,PL21,72984,71456,1896,368,1528
2021-05-30,CL,14,PL45,295776,292384,2816,2816,0
2021-11-18,PRG,12,PL14,376128,365216,10912,10912,0
2021-03-04,CA,23,PL02,189648,189384,672,672,0
2021-11-26,SD,13,PL18,75127,74544,1145,576,569
2021-07-25,PR,15,PL12,138960,138848,448,448,0
2021-12-02,CA,23,PL02,235008,234600,936,936,0
2021-10-26,NT,16,PL51,494976,494464,1152,1152,0
2021-10-25,CL,14,PL45,293536,288512,3552,3552,0
2021-01-20,SD,13,PL22,66082,65288,1709,896,813
2021-02-04,CH,24,PL08,174696,164728,21398,5920,15478
2021-11-12,SB,11,PL50,457664,456480,1760,1760,0
2021-04-25,CA,23,PL11,232152,227352,5160,5160,0
2021-04-22,CA,23,PL02,178560,177912,2328,2328,0
2021-05-04,RT,21,PL41,0,0,0,0,0
2021-11-22,CH,24,PL07,252464,244297,19324,11072,8252
2021-04-08,SB,11,PL50,452320,450848,2112,2112,0
2021-05-28,RA,17,PL35,193632,191136,3456,3456,0
2021-10-26,HO,18,PL03,66944,66856,88,88,0
2021-01-23,HO,18,PL01,60104,59824,296,296,0
2021-03-23,HO,18,PL30,65480,65400,88,88,0
2021-06-01,SD,13,PL17,76271,75521,750,0,750
2021-02-02,CH,24,PL07,183858,175568,8322,32,8290
2021-10-30,HO,18,PL03,47152,46896,352,352,0
2021-07-01,RA,17,PL34,163224,162504,1824,1824,0
2021-11-25,PRG,12,PL14,392256,391904,960,960,0
2021-10-28,DI,19,PL52,257664,251808,7168,7168,0
2021-12-18,PW,26,PL37,818544,816672,2832,2832,0
2021-04-22,RT,21,PL05,199680,199344,864,864,0
2021-12-04,SB,11,PL50,455840,454880,1792,1792,0
2021-01-19,CA,23,PL31,122112,121296,816,816,0
2021-02-01,RT,21,PL05,203640,201408,2568,2568,0
2021-07-08,SD,13,PL25,68855,68140,1097,352,745
2021-12-05,RA,17,PL34,146640,142200,6576,6576,0
2021-04-27,SD,13,PL21,72981,72292,906,192,714
2021-11-19,SD,13,PL18,76282,75969,713,400,313
2021-07-07,HO,18,PL01,45104,44768,352,352,0
2021-07-27,PW,26,PL37,530304,491376,38928,38928,0
2021-02-28,PRG,12,PL14,386656,386368,704,704,0
2021-06-22,PRG,12,PL14,390944,390944,864,864,0
2021-02-17,SD,13,PL25,73321,73267,438,384,54
2021-04-09,CH,24,PL12,164304,164560,192,192,0
2021-09-23,HO,18,PL11,63456,63272,184,184,0
2021-06-23,SB,11,PL50,452800,452448,2208,2208,0
2021-01-14,CH,24,PL08,298356,289959,17730,8992,8738
2021-06-20,RA,17,PL34,220680,219936,1008,1008,0
2021-09-29,SD,13,PL22,76617,76520,353,256,97
2021-04-15,CL,14,PL45,293376,268448,3296,3296,0
2021-11-30,HO,18,PL09,8600,8488,112,112,0
2021-09-10,SD,13,PL21,76643,76313,355,0,355
2021-06-04,SB,11,PL36,250632,249120,7200,7200,0
2021-01-06,RT,21,PL06,204624,204768,336,336,0
2021-09-03,CH,24,PL57,34392,34336,56,56,0
2021-06-08,CL,14,PL45,195424,179392,9472,9472,0
2021-05-02,PRG,12,PL14,390656,389408,1536,1536,0
2021-02-09,DI,19,PL53,276640,276192,1664,1664,0
2021-10-29,PR,15,PL04,0,0,14784,14784,0
2021-09-03,RA,17,PL35,188136,187152,1128,1128,0
2021-11-12,CA,23,PL13,75336,75336,184,184,0
2021-12-04,DI,19,PL52,235328,234880,704,704,0
2021-02-14,CA,23,PL02,192648,190368,2496,2496,0
2021-09-24,PB,25,PL54,0,0,3328,3328,0
2021-03-15,CL,14,PL44,257760,250272,2496,2496,0
2021-05-26,SB,11,PL50,456128,454784,2432,2432,0
2021-10-18,SD,13,PL21,66027,65728,475,176,299
2021-06-30,PR,15,PL24,264928,264960,448,448,0
2021-01-30,HO,18,PL03,66480,66320,200,200,0
2021-09-10,HO,18,PL30,0,0,800,800,0
2021-04-26,HO,18,PL30,66224,66224,0,0,0
2021-07-23,SD,13,PL25,69485,68300,3569,2384,1185
2021-12-13,EC,10,PL43,627552,627072,528,528,0
2021-04-26,PR,15,PL24,265632,263904,1888,1888,0
2021-12-11,SD,13,PL20,69652,69146,1128,608,520
2021-12-03,CA,23,PL13,85280,85104,224,224,0
2021-11-01,SD,13,PL20,76238,75917,552,176,376
2021-11-13,CA,23,PL02,196560,195696,1152,1152,0
2021-03-17,RA,17,PL35,218688,218040,720,720,0
2021-03-06,CA,23,PL02,237360,235152,2568,2568,0
2021-08-15,CH,24,PL08,223283,202296,37515,2112,35403
2021-04-10,RT,21,PL42,191072,189376,1808,1808,0
2021-06-04,HO,18,PL32,67592,67160,432,432,0
2021-03-18,CA,23,PL13,84040,84024,200,200,0
2021-05-31,HO,18,PL33,132496,132496,0,0,0
2021-07-02,HO,18,PL09,71624,71536,88,88,0
2021-03-25,CH,24,PL08,3713,3205,18554,5824,12730
2021-07-01,PB,25,PL55,446496,442432,4896,4896,0
2021-02-12,SD,13,PL22,68933,68813,1465,1344,121
2021-04-26,CH,24,PL07,240553,235232,13569,5280,8289
2021-02-02,SB,11,PL50,0,0,0,0,0
2021-04-02,CH,24,PL07,69860,68318,10298,5408,4890
2021-07-30,HO,18,PL09,69336,69032,344,344,0
2021-08-17,SD,13,PL25,25253,25064,365,176,189
2021-04-16,PW,26,PL37,794016,785520,10320,10320,0
2021-08-31,HO,18,PL10,68376,68208,216,216,0
2021-06-18,PR,15,PL24,263232,262400,1632,1632,0
2021-11-19,SD,13,PL21,63947,63499,1494,1024,470
2021-03-05,HO,18,PL03,66224,66224,0,0,0
2021-11-01,CL,14,PL45,282400,273568,7520,7520,0
2021-07-12,SD,13,PL19,59856,59786,1686,1616,70
2021-09-29,CH,24,PL57,34132,34112,68,68,0
2021-09-29,HO,18,PL33,132512,132512,0,0,0
2021-03-29,DI,19,PL52,272704,271552,1152,1152,0
2021-06-05,CA,23,PL13,82872,80752,2176,2176,0
2021-06-20,HO,18,PL01,60928,60768,160,160,0
2021-07-18,SD,13,PL18,67584,66659,2125,1200,925
2021-07-25,PRG,12,PL14,388800,387616,1472,1472,0
2021-06-14,HO,18,PL32,63512,63272,240,240,0
2021-04-29,PRG,12,PL14,391296,389024,2272,2272,0
2021-11-21,HO,18,PL40,63440,63272,440,440,0
2021-01-04,RA,17,PL56,137712,131712,8592,8592,0
2021-10-08,DI,19,PL52,97088,96768,320,320,0
2021-09-08,HO,18,PL01,45800,44856,1040,1040,0
2021-01-09,CH,24,PL57,32664,32604,108,108,0
2021-03-29,RA,17,PL35,169080,165744,3528,3528,0
2021-04-12,HO,18,PL09,68872,68792,104,104,0
2021-10-15,RA,17,PL35,11040,9576,1464,1464,0
2021-04-04,CA,23,PL02,233208,232704,672,672,0
2021-10-17,CA,23,PL31,220896,217896,3408,3408,0
2021-07-09,PB,25,PL54,382176,373792,9408,9408,0
2021-07-01,CL,14,PL44,167008,162880,2368,2368,0
2021-03-14,SD,13,PL20,75061,74687,902,528,374
2021-11-24,HO,18,PL11,65528,65152,376,376,0
2021-02-26,SD,13,PL18,53638,52527,3735,2608,1127
2021-03-12,SD,13,PL22,69801,69522,2052,1728,324
2021-06-08,PR,15,PL24,261152,259968,1440,1440,0
2021-06-15,HO,18,PL09,72080,71992,88,88,0
2021-09-26,HO,18,PL01,67240,67016,320,320,0
2021-07-12,SD,13,PL25,4994,4966,152,96,56
2021-08-02,HO,18,PL30,66128,66152,0,0,0
2021-02-28,SB,11,PL36,316176,315480,1008,1008,0
2021-05-17,HO,18,PL33,65960,65664,296,296,0
2021-07-29,EC,10,PL43,609072,604464,4464,4464,0
2021-10-12,SD,13,PL19,62687,62364,2228,1904,324
2021-09-01,CA,23,PL02,182088,181560,744,744,0
2021-08-10,SD,13,PL22,75632,75564,596,528,68
2021-01-14,CH,24,PL57,33948,33908,40,40,0
2021-03-11,CH,24,PL08,284443,281896,10512,7808,2704
2021-06-23,SD,13,PL21,73108,72657,1367,832,535
2021-08-14,HO,18,PL10,68736,68656,144,144,0
2021-12-11,PR,15,PL24,267808,267296,704,704,0
2021-05-15,SD,13,PL19,31319,31280,4654,4080,574
2021-01-09,HO,18,PL01,65688,65360,328,328,0
2021-06-04,SD,13,PL19,67936,67395,1134,560,574
2021-09-17,RT,21,PL42,185824,182896,2928,2928,0
2021-09-06,RT,21,PL06,0,0,0,0,0
2021-12-02,SB,11,PL36,211584,211536,336,336,0
2021-07-28,CA,23,PL31,0,0,384,384,0
2021-08-05,CH,24,PL07,303221,295247,14696,6560,8136
2021-08-16,RT,21,PL41,4256,2224,2032,2032,0
2021-12-09,RA,17,PL56,258672,258480,840,840,0
2021-01-18,SD,13,PL17,63559,63380,753,544,209
2021-01-17,HO,18,PL33,68664,68736,0,0,0
2021-12-08,SD,13,PL21,39445,39159,2093,1792,301
2021-01-26,CH,24,PL57,33468,33460,92,92,0
2021-03-22,CA,23,PL02,147264,144048,3600,3600,0
2021-05-05,SB,11,PL36,285528,283944,1896,1896,0
2021-07-03,SB,11,PL50,462240,461024,1472,1472,0
2021-10-18,HO,18,PL40,66288,66288,0,0,0
2021-03-22,DI,19,PL53,292512,291136,1440,1440,0
2021-10-22,SD,13,PL18,76452,75945,507,0,507
2021-06-02,PB,25,PL54,437984,435072,3584,3584,0
2021-05-02,CA,23,PL11,236040,234576,1584,1584,0
2021-04-11,SD,13,PL22,74677,74612,469,368,101
2021-02-18,DI,19,PL53,292896,293248,512,512,0
2021-06-29,PB,25,PL55,448224,448256,960,960,0
2021-08-09,SD,13,PL17,72628,71431,1565,368,1197
2021-02-10,HO,18,PL33,29504,27856,1680,1680,0
2021-01-23,HO,18,PL03,65856,65304,536,536,0
2021-02-27,CL,14,PL44,296512,284928,5024,5024,0
2021-07-06,HO,18,PL10,0,0,112,112,0
2021-01-09,SD,13,PL17,72611,72531,465,384,81
2021-12-16,HO,18,PL03,8648,6832,1816,1816,0
2021-10-30,PB,25,PL55,373024,358080,19200,19200,0
2021-07-27,SD,13,PL18,73655,73655,640,640,0
2021-08-04,HO,18,PL09,72360,72328,112,112,0
2021-05-03,RT,21,PL06,207408,207312,648,648,0
2021-05-17,SD,13,PL17,57894,56784,1740,544,1196
2021-05-17,RA,17,PL34,220872,220680,576,576,0
2021-11-20,RT,21,PL41,158752,149120,9632,9632,0
2021-03-05,PB,25,PL55,441696,436928,8256,8256,0
2021-04-25,CA,23,PL02,224640,221736,3000,3000,0
2021-10-01,SB,11,PL36,299472,298200,1608,1608,0
2021-11-01,DI,19,PL52,242528,241248,1536,1536,0
2021-11-24,CH,24,PL57,34008,33964,44,44,0
2021-10-29,SD,13,PL21,20011,19894,293,176,117
2021-06-01,PW,26,PL37,678384,618816,60480,60480,0
2021-06-29,HO,18,PL32,63264,63216,144,144,0
2021-09-18,RA,17,PL35,233472,232128,1344,1344,0
2021-02-27,NT,16,PL57,151472,150752,784,784,0
2021-08-10,HO,18,PL40,37472,37432,40,40,0
2021-11-13,CL,14,PL44,294976,287328,5824,5824,0
2021-03-15,RT,21,PL41,0,0,5024,5024,0
2021-10-25,CL,14,PL44,292704,286688,5408,5408,0
2021-02-28,SD,13,PL19,34165,33881,787,176,611
2021-11-22,RT,21,PL42,178160,175472,3120,3120,0
2021-04-21,CH,24,PL07,169437,165043,13898,9504,4394
2021-05-11,CL,14,PL45,300672,296864,2976,2976,0
2021-10-22,RT,21,PL06,203208,201576,1680,1680,0
2021-07-25,RA,17,PL34,0,0,2832,2832,0
2021-02-21,PR,15,PL24,172064,158848,13312,13312,0
2021-05-26,SB,11,PL36,257136,250008,7128,7128,0
2021-01-27,HO,18,PL11,61384,61248,136,136,0
2021-02-09,HO,18,PL01,22352,22232,120,120,0
2021-05-31,CA,23,PL31,231888,229872,2208,2208,0
2021-08-07,EC,10,PL43,621840,620112,1776,1776,0
2021-05-27,HO,18,PL01,68128,67024,1104,1104,0
2021-06-30,PW,26,PL37,776928,769824,8304,8304,0
2021-12-13,SD,13,PL22,51469,51315,378,208,170
2021-02-12,RT,21,PL05,184080,183864,1224,1224,0
2021-10-04,RA,17,PL34,225888,218664,7224,7224,0
2021-02-11,NT,16,PL51,467136,462688,4640,4640,0
2021-07-06,SD,13,PL25,70923,70357,950,384,566
2021-08-19,PRG,12,PL14,0,0,5440,5440,0
2021-11-07,NT,16,PL51,509024,508128,1120,1120,0
2021-05-25,CL,14,PL44,288640,278976,7616,7616,0
2021-06-03,SD,13,PL21,69240,68736,908,384,524
2021-09-10,CA,23,PL31,234792,234576,360,360,0
2021-11-06,CH,24,PL57,34060,34016,44,44,0
2021-03-28,SD,13,PL20,75827,75692,379,192,187
2021-08-14,SD,13,PL17,73441,73276,964,800,164
2021-03-24,SD,13,PL17,66479,66234,1715,1376,339
2021-11-11,HO,18,PL32,55936,55640,296,296,0
2021-06-05,HO,18,PL40,66328,66328,0,0,0
2021-08-07,HO,18,PL01,67664,67440,224,224,0
2021-09-28,HO,18,PL33,129040,128864,432,432,0
2021-01-17,RA,17,PL34,217608,216192,1488,1488,0
2021-04-07,CA,23,PL13,69192,68560,720,720,0
2021-11-22,HO,18,PL11,66408,66408,0,0,0
2021-10-20,CA,23,PL02,222864,222024,984,984,0
2021-01-15,HO,18,PL03,67808,67808,0,0,0
2021-04-19,SD,13,PL18,39438,39453,496,432,64
2021-08-27,SD,13,PL18,75072,74610,814,352,462
2021-05-05,HO,18,PL09,73224,73224,0,0,0
2021-09-03,PR,15,PL24,265376,265216,384,384,0
2021-01-11,HO,18,PL30,66160,66160,0,0,0
2021-11-14,HO,18,PL40,66272,66176,96,96,0
2021-06-18,HO,18,PL09,71288,71152,392,392,0
2021-09-11,PB,25,PL55,215680,186432,29248,29248,0
2021-10-12,HO,18,PL09,67264,67040,224,224,0
2021-06-03,PRG,12,PL14,391648,390496,1280,1280,0
2021-09-23,NT,16,PL51,466752,458848,9408,9408,0
2021-06-24,HO,18,PL03,35944,35512,704,704,0
2021-12-19,PR,15,PL24,267840,267968,0,0,0
2021-06-04,HO,18,PL10,45152,44848,368,368,0
2021-01-30,RT,21,PL42,12512,9360,14880,14880,0
2021-07-21,HO,18,PL10,65752,65448,304,304,0
2021-02-22,RT,21,PL42,181984,179888,2320,2320,0
2021-04-27,RA,17,PL35,154128,151512,3120,3120,0
2021-04-29,EC,10,PL43,41056,37120,6256,6256,0
2021-07-02,SD,13,PL25,70097,69530,1047,480,567
2021-09-18,HO,18,PL40,66288,66280,8,8,0
2021-12-13,SD,13,PL19,68103,66798,1699,384,1315
2021-01-27,PR,15,PL04,262464,262016,832,832,0
2021-02-04,HO,18,PL10,45096,44288,808,808,0
2021-02-24,PRG,12,PL14,397024,397312,160,160,0
2021-03-27,NT,16,PL57,141936,141712,192,192,0
2021-09-03,HO,18,PL01,67576,67024,624,624,0
2021-06-30,RT,21,PL41,23488,16800,6688,6688,0
2021-06-14,NT,16,PL51,463008,462496,1504,1504,0
2021-06-08,HO,18,PL33,131024,130816,208,208,0
2021-11-12,CA,23,PL02,231504,231336,288,288,0
2021-07-14,HO,18,PL30,59112,58920,320,320,0
2021-03-30,RA,17,PL56,221928,220488,1440,1440,0
2021-08-15,HO,18,PL56,65720,65192,528,528,0
2021-02-08,SD,13,PL21,44509,37766,8691,736,7955
2021-01-24,CA,23,PL31,222912,219648,3624,3624,0
2021-10-02,SB,11,PL50,453696,450848,3488,3488,0
2021-09-14,CL,14,PL44,298112,295456,2624,2624,0
2021-05-11,RT,21,PL42,0,0,0,0,0
2021-11-19,CL,14,PL45,292640,289376,2208,2208,0
2021-11-25,HO,18,PL40,15888,15368,1000,1000,0
2021-04-06,PW,26,PL37,374784,375264,10224,10224,0
2021-07-28,CL,14,PL45,202400,200544,1504,1504,0
2021-08-05,SD,13,PL18,68850,68397,1058,592,466
2021-12-06,PB,25,PL55,300448,265760,37856,37856,0
2021-12-20,RT,21,PL05,162120,160512,6000,6000,0
2021-05-18,SD,13,PL19,54766,54735,1113,1072,41
2021-04-11,HO,18,PL30,66128,66184,0,0,0
2021-10-03,PB,25,PL55,428608,423904,5184,5184,0
2021-02-11,SD,13,PL17,74578,73055,2013,384,1629
2021-03-10,CH,24,PL07,298206,291908,9717,3232,6485
2021-10-07,RT,21,PL42,11072,10400,3040,3040,0
2021-11-27,HO,18,PL09,26792,26144,704,704,0
2021-11-11,PRG,12,PL12,382912,377760,7936,7936,0
2021-03-13,DI,19,PL52,261024,260288,1312,1312,0
2021-12-19,PRG,12,PL14,390048,388512,2592,2592,0
2021-09-07,PB,25,PL55,0,0,5440,5440,0
2021-09-13,HO,18,PL56,66064,65616,448,448,0
2021-02-09,CL,14,PL45,278592,267648,4960,4960,0
2021-12-06,PRG,12,PL54,0,0,16320,16320,0
2021-05-05,RT,21,PL42,2864,2528,4928,4928,0
2021-07-28,SD,13,PL17,50188,48037,8471,6304,2167
2021-09-07,SB,11,PL36,313608,311760,2112,2112,0
2021-01-27,NT,16,PL51,467232,465632,2368,2368,0
2021-04-07,SD,13,PL25,73833,73682,519,368,151
2021-10-23,HO,18,PL03,66504,66272,232,232,0
2021-10-09,RA,17,PL34,116352,108720,7632,7632,0
2021-03-17,CH,24,PL08,204924,191358,15998,2432,13566
2021-02-02,HO,18,PL10,47128,44992,2136,2136,0
2021-09-24,CL,14,PL45,130912,124224,3808,3808,0
2021-04-19,SD,13,PL19,42762,42829,989,976,13
2021-01-10,NT,16,PL51,462720,459776,4448,4448,0
2021-03-22,CA,23,PL13,74584,74632,592,592,0
2021-07-10,CH,24,PL08,306848,300065,13055,6272,6783
2021-07-03,RT,21,PL06,194256,192576,1992,1992,0
2021-09-18,HO,18,PL33,130464,130080,480,480,0
2021-11-26,NT,16,PL51,385408,379008,11680,11680,0
2021-05-03,SD,13,PL19,57952,57934,1115,1088,27
2021-07-12,CL,14,PL44,293664,291296,1952,1952,0
2021-11-16,CL,14,PL44,296512,293088,2688,2688,0
2021-07-10,SD,13,PL18,73406,73070,1761,1408,353
2021-02-23,RT,21,PL06,204240,203544,696,696,0
2021-03-30,RT,21,PL42,191520,190656,1184,1184,0
2021-08-18,SD,13,PL17,0,0,0,0,0
2021-10-22,SD,13,PL22,75792,75703,471,368,103
2021-07-20,HO,18,PL33,66224,66224,0,0,0
2021-09-26,RT,21,PL06,209016,208968,48,48,0
2021-06-18,RA,17,PL35,216528,211704,5280,5280,0
2021-12-03,HO,18,PL01,47576,46792,920,920,0
2021-03-02,HO,18,PL03,66112,66136,0,0,0
2021-09-11,PB,25,PL54,441504,430048,11744,11744,0
2021-05-18,RA,17,PL35,200760,198216,2664,2664,0
2021-07-06,PW,26,PL37,815376,810576,6336,6336,0
2021-02-13,PB,25,PL55,423296,417600,6688,6688,0
2021-09-22,RA,17,PL34,200232,193776,6456,6456,0
2021-01-02,CL,14,PL44,215680,211712,1440,1440,0
2021-05-28,SD,13,PL17,74878,74208,1150,480,670
2021-01-05,RT,21,PL05,209592,209808,0,0,0
2021-03-17,HO,18,PL30,43224,42896,472,472,0
2021-10-12,HO,18,PL56,66176,66064,112,112,0
2021-06-21,SD,13,PL19,73974,73924,272,208,64
2021-11-28,RT,21,PL06,204264,204048,312,312,0
2021-05-04,CH,24,PL12,157360,156704,992,992,0
2021-05-20,CH,24,PL08,282167,275711,18585,11968,6617
2021-10-15,PW,26,PL37,810912,810768,2208,2208,0
2021-11-30,CL,14,PL45,252224,246240,4320,4320,0
2021-03-12,RA,17,PL34,217344,216840,600,600,0
2021-03-05,CH,24,PL08,285345,277750,15961,7904,8057
2021-06-17,CH,24,PL07,255270,241270,16784,2784,14000
2021-09-26,PR,15,PL04,255776,249216,6880,6880,0
2021-02-27,CH,24,PL12,95904,90496,5760,5760,0
2021-07-10,HO,18,PL33,66152,66152,0,0,0
2021-09-12,CL,14,PL45,293632,287584,4768,4768,0
2021-09-28,CA,23,PL31,177864,176952,1896,1896,0
2021-07-28,HO,18,PL01,65984,65688,296,296,0
2021-10-23,DI,19,PL52,84640,82240,2880,2880,0
2021-05-05,DI,19,PL53,271360,269856,2368,2368,0
2021-10-22,HO,18,PL40,63432,63416,200,200,0
2021-05-02,CH,24,PL07,283284,274098,29060,19808,9252
2021-02-24,RA,17,PL35,189768,189096,1752,1752,0
2021-02-06,HO,18,PL03,66232,66232,0,0,0
2021-05-04,PB,25,PL54,445376,445600,1088,1088,0
2021-01-22,HO,18,PL33,65480,65392,88,88,0
2021-06-23,RT,21,PL42,183376,176672,7600,7600,0
2021-12-01,HO,18,PL09,41784,40176,1608,1608,0
2021-06-15,PR,15,PL24,267808,267232,704,704,0
2021-02-09,SB,11,PL50,424448,423072,2592,2592,0
2021-01-28,HO,18,PL30,59856,59632,224,224,0
2021-05-01,CH,24,PL12,153232,152336,1104,1104,0
2021-01-12,CA,23,PL13,84192,82896,1328,1328,0
2021-06-05,RT,21,PL06,206712,205056,1800,1800,0
2021-04-09,SD,13,PL17,74511,74303,594,352,242
2021-04-26,CA,23,PL13,85120,84672,616,616,0
2021-10-17,HO,18,PL11,50064,49832,232,232,0
2021-09-25,HO,18,PL03,65080,63848,1312,1312,0
2021-01-26,PR,15,PL24,265504,261088,4640,4640,0
2021-02-19,SB,11,PL50,457376,456672,1760,1760,0
2021-05-19,SB,11,PL50,449664,439616,11968,11968,0
2021-05-23,CA,23,PL02,207024,200472,6528,6528,0
2021-11-22,SB,11,PL36,293328,284640,8688,8688,0
2021-12-10,SB,11,PL50,352032,341600,10816,10816,0
2021-10-05,SD,13,PL22,74985,74925,716,656,60
2021-07-06,SD,13,PL20,75883,75867,234,192,42
2021-01-04,SD,13,PL25,70369,69241,1505,352,1153
2021-09-23,RA,17,PL34,118872,118152,816,816,0
2021-04-28,SB,11,PL36,304320,303168,1512,1512,0
2021-01-16,SD,13,PL21,57286,55709,2948,1328,1620
2021-05-01,SD,13,PL20,73679,73610,713,528,185
2021-06-02,PW,26,PL37,0,0,11280,11280,0
2021-10-02,CH,24,PL12,160528,160320,528,528,0
2021-11-25,SB,11,PL36,306912,302688,4536,4536,0
2021-04-23,RT,21,PL41,0,0,0,0,0
2021-12-21,HO,18,PL33,24872,22736,2136,2136,0
2021-03-28,PW,26,PL37,811920,807024,6288,6288,0
2021-01-21,CA,23,PL31,232104,230520,1728,1728,0
2021-04-16,HO,18,PL11,66280,66280,0,0,0
2021-12-13,SD,13,PL25,64133,63168,1490,512,978
2021-03-23,HO,18,PL11,66208,66208,0,0,0
2021-03-04,EC,10,PL43,625392,624864,1104,1104,0
2021-01-24,RT,21,PL05,202632,199992,3072,3072,0
2021-05-13,CA,23,PL31,93240,91848,2544,2544,0
2021-10-20,SD,13,PL21,48752,48511,2798,2528,270
2021-09-17,SB,11,PL36,295344,294216,1728,1728,0
2021-08-31,SD,13,PL25,4076,3956,5683,5072,611
2021-08-21,PR,15,PL04,339808,338144,1696,1696,0
2021-02-13,PW,26,PL37,815040,813984,2256,2256,0
2021-12-17,RT,21,PL06,203568,203400,288,288,0
2021-12-20,HO,18,PL03,6896,4648,2248,2248,0
2021-03-18,RT,21,PL05,206568,206448,288,288,0
2021-03-19,DI,19,PL53,284352,281216,3648,3648,0
2021-03-06,HO,18,PL33,62544,62352,192,192,0
2021-04-27,CL,14,PL45,0,0,0,0,0
2021-05-01,SD,13,PL25,73678,73564,544,352,192
2021-11-21,PRG,12,PL12,359264,334784,24480,24480,0
2021-03-26,PB,25,PL55,67040,66240,800,800,0
2021-11-21,CA,23,PL13,84240,84072,200,200,0
2021-10-21,CH,24,PL12,164240,164128,176,176,0
2021-11-07,SD,13,PL20,74001,73428,989,416,573
2021-10-05,CH,24,PL08,262815,258749,8518,3712,4806
2021-06-14,CL,14,PL44,286400,280704,5632,5632,0
2021-12-12,PB,25,PL55,365984,353472,14880,14880,0
2021-06-03,HO,18,PL33,132496,132496,0,0,0
2021-11-23,HO,18,PL40,66256,66144,112,112,0
2021-05-13,PB,25,PL55,427392,410688,17248,17248,0
2021-08-13,SD,13,PL19,65627,65502,2973,2848,125
2021-08-25,PR,15,PL04,352288,351200,1472,1472,0
2021-12-04,RA,17,PL56,259920,258504,1416,1416,0
2021-08-09,SD,13,PL20,47278,45909,1595,192,1403
2021-11-30,SD,13,PL21,24801,24437,1403,752,651
2021-11-08,NT,16,PL51,511136,511200,384,384,0
2021-02-21,CA,23,PL02,212328,210576,1944,1944,0
2021-06-20,PR,15,PL24,263456,263648,608,608,0
2021-08-09,HO,18,PL03,66872,66880,88,88,0
2021-11-16,CH,24,PL57,33992,33976,40,40,0
2021-08-16,SB,11,PL36,263136,254832,8688,8688,0
2021-08-05,CH,24,PL08,249317,241272,16664,6336,10328
2021-11-07,HO,18,PL40,65360,65280,176,176,0
2021-02-27,PR,15,PL24,257024,255616,3200,3200,0
2021-09-05,SD,13,PL19,74948,74932,226,192,34
2021-04-21,HO,18,PL10,56880,56840,88,88,0
2021-08-26,SD,13,PL22,76270,76210,268,192,76
2021-02-06,DI,19,PL53,293152,291680,1824,1824,0
2021-06-03,PB,25,PL54,429632,418240,12480,12480,0
2021-07-06,HO,18,PL30,66216,66216,0,0,0
2021-12-05,CA,23,PL02,88968,85776,3192,3192,0
2021-02-15,PB,25,PL55,402944,388256,16160,16160,0
2021-08-08,HO,18,PL09,51712,51608,168,168,0
2021-04-01,CL,14,PL44,4448,0,4448,4448,0
2021-02-11,HO,18,PL33,45896,43912,2040,2040,0
2021-07-06,CA,23,PL11,233304,232824,1152,1152,0
2021-01-09,HO,18,PL09,66288,66288,0,0,0
2021-05-09,CA,23,PL11,230712,226944,3960,3960,0
2021-09-18,PB,25,PL55,447840,446304,1536,1536,0
2021-08-10,SD,13,PL17,72886,71849,1710,656,1054
2021-04-06,SB,11,PL50,424384,422144,3808,3808,0
2021-04-04,HO,18,PL10,40032,39768,264,264,0
2021-11-14,CH,24,PL57,33776,33692,124,124,0
2021-02-09,RA,17,PL56,112224,110880,7320,7320,0
2021-07-18,EC,10,PL43,489024,485760,3024,3024,0
2021-11-24,RT,21,PL06,208488,208704,144,144,0
2021-01-25,SD,13,PL17,72821,72746,267,192,75
2021-01-04,SD,13,PL17,72131,71576,939,368,571
2021-03-23,CA,23,PL31,204840,204072,1560,1560,0
2021-11-25,CH,24,PL57,33708,33576,132,132,0
2021-12-22,HO,18,PL32,55328,55272,472,472,0
2021-09-22,HO,18,PL33,132512,132512,0,0,0
2021-01-02,NT,16,PL51,308160,306080,2624,2624,0
2021-01-05,RA,17,PL56,212472,207264,5208,5208,0
2021-03-15,PR,15,PL24,267776,266912,992,992,0
2021-09-07,PR,15,PL24,267520,267168,544,544,0
2021-12-09,HO,18,PL09,39040,38928,112,112,0
2021-03-16,NT,16,PL51,413472,413312,2752,2752,0
2021-10-16,PB,25,PL54,447968,445152,3712,3712,0
2021-10-18,HO,18,PL33,132320,132352,0,0,0
2021-09-17,HO,18,PL40,65576,65472,104,104,0
2021-10-18,RA,17,PL34,213984,212280,2208,2208,0
2021-10-06,CH,24,PL12,164848,164704,288,288,0
2021-10-21,DI,19,PL53,294112,293248,1024,1024,0
2021-01-30,SD,13,PL25,29553,27292,3125,864,2261
2021-09-20,SD,13,PL22,63689,63296,781,368,413
2021-04-12,CH,24,PL08,246886,231814,24120,8928,15192
2021-05-21,PR,15,PL04,199136,197536,2048,2048,0
2021-07-31,RT,21,PL05,203808,203232,888,888,0
2021-07-01,CH,24,PL08,213437,200867,20537,7360,13177
2021-09-11,SD,13,PL18,75811,75501,902,592,310
2021-05-28,HO,18,PL40,65160,65056,48,48,0
2021-07-04,HO,18,PL10,44856,43552,1400,1400,0
2021-10-13,EC,10,PL43,584304,563616,22512,22512,0
2021-06-14,CA,23,PL13,0,0,0,0,0
2021-09-27,HO,18,PL09,64392,64296,96,96,0
2021-04-13,PR,15,PL04,264512,263616,1312,1312,0
2021-11-03,SD,13,PL18,69899,69532,1209,832,377
2021-03-13,HO,18,PL09,71576,71440,208,208,0
2021-08-27,SD,13,PL17,392,0,392,0,392
2021-08-18,SD,13,PL18,0,0,0,0,0
2021-04-10,SD,13,PL21,72952,72746,222,16,206
2021-04-16,HO,18,PL10,57688,57688,0,0,0
2021-05-29,PB,25,PL54,385632,382944,3616,3616,0
2021-02-19,HO,18,PL01,57560,55752,1848,1848,0
2021-10-23,CH,24,PL57,34120,34080,44,44,0
2021-08-17,SD,13,PL19,18731,18486,559,192,367
2021-12-04,SD,13,PL17,60453,60143,502,192,310
2021-01-30,CA,23,PL13,59496,59320,176,176,0
2021-07-06,CH,24,PL08,307845,306063,5087,3040,2047
2021-01-23,SD,13,PL17,71227,70733,878,384,494
2021-09-18,EC,10,PL43,623664,623280,576,576,0
2021-10-04,SD,13,PL17,76374,76159,429,176,253
2021-10-15,EC,10,PL43,621840,621024,576,576,0
2021-03-11,EC,10,PL43,23328,9264,12096,12096,0
2021-06-01,DI,19,PL52,288992,287872,1504,1504,0
2021-12-03,RT,21,PL06,206232,206136,408,408,0
2021-02-04,CA,23,PL31,0,0,1536,1536,0
2021-06-12,CH,24,PL07,223238,219232,11470,7520,3950
2021-02-22,DI,19,PL52,296160,296096,384,384,0
2021-11-06,HO,18,PL09,67288,67248,120,120,0
2021-12-03,SD,13,PL22,75928,75889,456,384,72
2021-05-11,PW,26,PL37,759216,737040,23520,23520,0
2021-09-25,RT,21,PL42,150192,135856,24240,24240,0
2021-01-23,DI,19,PL52,295456,295744,352,352,0
2021-02-14,CL,14,PL44,11552,1504,8800,8800,0
2021-07-12,HO,18,PL56,2480,2288,192,192,0
2021-09-30,SB,11,PL50,423744,422240,3744,3744,0
2021-07-03,HO,18,PL03,66872,66856,88,88,0
2021-04-07,CH,24,PL12,164528,164720,192,192,0
2021-07-17,HO,18,PL33,64440,64328,112,112,0
2021-06-14,SD,13,PL20,0,0,0,0,0
2021-04-03,HO,18,PL10,32536,32096,440,440,0
2021-02-02,RT,21,PL06,206400,205776,960,960,0
2021-01-30,SB,11,PL50,11392,0,11392,11392,0
2021-02-15,SD,13,PL22,64465,64371,519,368,151
2021-04-28,CA,23,PL31,225480,224208,1416,1416,0
2021-07-26,SD,13,PL22,0,0,10188,8928,1260
2021-11-18,PB,25,PL54,439968,427872,14656,14656,0
2021-10-01,SD,13,PL25,76426,75652,951,176,775
2021-12-22,PRG,12,PL14,392672,389600,3680,3680,0
2021-12-12,SD,13,PL25,66239,65798,640,176,464
2021-03-23,SD,13,PL19,0,0,853,384,469
2021-05-30,RT,21,PL42,188880,158240,30960,30960,0
2021-03-23,RT,21,PL06,183888,179064,4848,4848,0
2021-06-06,SD,13,PL21,76555,75894,837,176,661
2021-04-07,PB,25,PL55,282304,281152,3456,3456,0
2021-10-20,PW,26,PL37,561552,554256,35856,35856,0
2021-08-26,CH,24,PL12,159872,158224,1696,1696,0
2021-10-06,DI,19,PL53,293792,293984,448,448,0
2021-11-16,RT,21,PL05,0,0,4008,4008,0
2021-12-05,SD,13,PL22,68291,68227,710,624,86
2021-01-11,SB,11,PL36,311472,309552,2976,2976,0
2021-03-27,RT,21,PL42,155136,151008,4224,4224,0
2021-04-25,PW,26,PL37,779808,777744,2736,2736,0
2021-03-29,DI,19,PL53,280096,278880,1664,1664,0
2021-06-10,RA,17,PL34,206376,201000,5376,5376,0
2021-07-21,SD,13,PL18,46001,45915,652,400,252
2021-01-06,HO,18,PL10,488,0,488,488,0
2021-03-30,HO,18,PL33,66224,66224,0,0,0
2021-03-08,RA,17,PL35,223272,223008,264,264,0
2021-07-09,HO,18,PL32,67568,67440,128,128,0
2021-11-25,HO,18,PL11,66096,65848,248,248,0
2021-03-02,RT,21,PL06,209400,209544,0,0,0
2021-10-26,HO,18,PL01,40208,38952,1256,1256,0
2021-03-09,RT,21,PL41,32496,688,31808,31808,0
2021-01-09,HO,18,PL30,65592,65488,104,104,0
2021-10-13,CH,24,PL07,309441,305396,8627,4064,4563
2021-04-28,PW,26,PL37,481968,483264,7776,7776,0
2021-06-07,HO,18,PL33,130704,130416,288,288,0
2021-10-19,SD,13,PL19,76502,76310,384,176,208
2021-03-21,SD,13,PL17,74456,74281,351,176,175
2021-02-18,RT,21,PL42,83808,82144,1936,1936,0
2021-04-23,DI,19,PL53,0,0,1824,1824,0
2021-02-26,SD,13,PL17,68466,68315,1255,1104,151
2021-10-04,CL,14,PL44,218016,200192,16160,16160,0
2021-04-13,SD,13,PL25,72634,72131,751,176,575
2021-03-06,HO,18,PL09,68688,68552,344,344,0
2021-07-07,SB,11,PL50,0,0,37632,37632,0
2021-03-16,HO,18,PL11,65368,65352,104,104,0
2021-09-14,HO,18,PL40,64624,64592,136,136,0
2021-11-15,SD,13,PL20,48922,48933,347,176,171
2021-02-09,SD,13,PL22,59024,58905,607,480,127
2021-08-18,PRG,12,PL14,0,0,768,768,0
2021-12-01,PR,15,PL04,260704,256416,4544,4544,0
2021-04-24,RA,17,PL56,218472,217584,1032,1032,0
2021-01-31,EC,10,PL43,620928,619248,1872,1872,0
2021-03-13,SB,11,PL36,130080,129360,816,816,0
2021-09-11,SD,13,PL25,71213,68932,2473,192,2281
2021-11-07,CA,23,PL31,0,0,3384,3384,0
2021-10-18,HO,18,PL09,67488,67456,88,88,0
2021-10-25,HO,18,PL01,65832,64952,944,944,0
2021-12-06,CA,23,PL31,154320,152448,2400,2400,0
2021-05-01,CA,23,PL02,230472,228840,2568,2568,0
2021-05-04,PB,25,PL55,46080,32800,13280,13280,0
2021-07-05,PR,15,PL12,66240,66064,368,368,0
2021-07-29,SD,13,PL19,63017,62992,201,176,25
2021-08-31,HO,18,PL01,48152,46912,1240,1240,0
2021-10-17,SD,13,PL19,42632,42563,245,176,69
2021-07-11,RT,21,PL42,181616,176992,5600,5600,0
2021-03-19,HO,18,PL01,65040,64384,656,656,0
2021-06-27,CA,23,PL31,233160,233064,408,408,0
2021-05-17,SD,13,PL19,75038,74963,1307,1232,75
2021-09-01,PB,25,PL54,257376,257504,480,480,0
2021-03-29,RT,21,PL41,0,0,0,0,0
2021-08-22,HO,18,PL11,48696,48640,112,112,0
2021-03-27,HO,18,PL03,52472,50080,2440,2440,0
2021-11-07,CH,24,PL07,250434,243448,11686,3712,7974
2021-03-29,RA,17,PL34,177240,176664,4368,4368,0
2021-08-28,HO,18,PL09,72264,72064,216,216,0
2021-10-25,PW,26,PL37,815424,804912,11040,11040,0
2021-04-14,PR,15,PL57,143200,142832,528,528,0
2021-07-27,HO,18,PL11,0,0,232,232,0
2021-09-16,CH,24,PL08,280024,257946,29729,7328,22401
2021-04-27,RT,21,PL05,205152,204768,456,456,0
2021-04-14,PB,25,PL55,157984,157408,2688,2688,0
2021-03-26,HO,18,PL33,31696,31568,256,256,0
2021-04-22,SD,13,PL17,67872,67547,1827,1424,403
2021-06-23,HO,18,PL30,64128,63944,184,184,0
2021-01-08,RA,17,PL34,143160,134448,8712,8712,0
2021-06-09,SD,13,PL19,21541,21432,6252,4512,1740
2021-05-01,RT,21,PL05,207576,207744,288,288,0
2021-03-21,PRG,12,PL14,381088,363840,17312,17312,0
2021-09-17,HO,18,PL33,132304,132032,272,272,0
2021-03-25,HO,18,PL01,66200,66096,104,104,0
2021-10-14,RA,17,PL34,215064,212712,3984,3984,0
2021-06-09,SD,13,PL18,65993,66017,2628,2400,228
2021-12-18,HO,18,PL03,11392,10720,672,672,0
2021-07-16,SD,13,PL20,39611,39601,13106,13056,50
2021-01-13,RA,17,PL56,222696,222696,0,0,0
2021-03-06,PB,25,PL55,18944,18944,0,0,0
2021-09-03,SD,13,PL18,72926,72604,732,368,364
2021-08-13,RA,17,PL34,220920,220656,720,720,0
2021-11-17,SD,13,PL19,74565,74495,529,384,145
2021-09-17,CA,23,PL13,84776,84768,168,168,0
2021-03-25,CH,24,PL07,314295,297745,19334,2784,16550
2021-06-01,CH,24,PL07,311659,301006,14855,4192,10663
2021-11-02,RA,17,PL34,235344,230976,4368,4368,0
2021-11-24,CH,24,PL12,97888,97728,448,448,0
2021-03-05,CH,24,PL12,162048,160992,1760,1760,0
2021-04-11,HO,18,PL10,56560,56544,120,120,0
2021-06-26,PB,25,PL54,298720,239680,59360,59360,0
2021-11-28,PW,26,PL37,813360,813024,1296,1296,0
2021-05-22,SD,13,PL25,0,0,32,32,0
2021-08-14,HO,18,PL40,66040,65752,472,472,0
2021-01-16,HO,18,PL11,64424,64016,408,408,0
2021-06-30,CA,23,PL11,189864,189696,528,528,0
2021-11-29,RT,21,PL06,204360,204168,312,312,0
2021-06-13,NT,16,PL51,454816,452352,3136,3136,0
2021-09-21,HO,18,PL33,128688,128560,240,240,0
2021-06-20,SB,11,PL50,456640,455776,1760,1760,0
2021-06-30,SD,13,PL21,74292,74054,532,208,324
2021-11-18,SB,11,PL50,401184,400672,4096,4096,0
2021-05-05,SD,13,PL17,69346,68919,1966,1488,478
2021-08-11,HO,18,PL40,66288,66256,32,32,0
2021-01-12,SD,13,PL18,68487,66881,2208,576,1632
2021-08-05,RT,21,PL05,180192,176904,3600,3600,0
2021-03-23,CH,24,PL07,225860,212445,25731,5344,20387
2021-03-28,PB,25,PL54,228096,196000,56928,56928,0
2021-05-06,RA,17,PL34,217800,217080,720,720,0
2021-10-03,SD,13,PL18,72155,71685,3854,3296,558
2021-09-16,DI,19,PL52,179104,178656,2144,2144,0
2021-04-24,PR,15,PL57,140096,139776,416,416,0
2021-04-25,HO,18,PL10,57680,57680,0,0,0
2021-03-31,HO,18,PL33,65152,65160,128,128,0
2021-10-13,HO,18,PL40,58024,57344,776,776,0
2021-03-18,SD,13,PL22,73050,72826,800,576,224
2021-01-16,PRG,12,PL14,393536,393088,832,832,0
2021-10-03,CA,23,PL31,140472,134616,6288,6288,0
2021-02-04,PR,15,PL57,138256,138080,176,176,0
2021-09-16,CH,24,PL07,118721,110576,11852,3616,8236
2021-03-10,RA,17,PL56,11496,10728,768,768,0
2021-12-17,RA,17,PL34,29448,28200,1248,1248,0
2021-06-28,CA,23,PL57,21856,21784,72,72,0
2021-09-06,SD,13,PL17,76285,76118,413,192,221
2021-04-12,CL,14,PL45,69408,67168,16128,16128,0
2021-01-29,SD,13,PL22,71766,71375,567,176,391
2021-06-26,SB,11,PL50,461440,460736,1984,1984,0
2021-06-12,HO,18,PL09,71736,71712,96,96,0
2021-01-23,HO,18,PL30,66152,66152,0,0,0
2021-10-01,SD,13,PL17,75941,75724,403,176,227
2021-01-21,HO,18,PL03,66232,65632,600,600,0
2021-04-11,CL,14,PL45,185344,182144,768,768,0
2021-05-29,HO,18,PL03,67608,67608,0,0,0
2021-10-20,EC,10,PL43,611760,609744,2544,2544,0
2021-08-05,HO,18,PL11,33216,32504,712,712,0
2021-10-30,SD,13,PL18,47687,47453,2257,1856,401
2021-04-10,HO,18,PL11,66288,66288,0,0,0
2021-12-03,EC,10,PL43,504192,501888,3552,3552,0
2021-06-18,HO,18,PL10,56560,56032,616,616,0
2021-02-01,SD,13,PL19,65771,63104,3051,384,2667
2021-02-06,SD,13,PL18,70015,69491,1122,592,530
2021-12-04,CA,23,PL13,84912,84872,104,104,0
2021-01-22,CH,24,PL08,224393,213034,26824,15328,11496
2021-05-01,SD,13,PL22,75223,74378,1133,288,845
2021-01-10,PR,15,PL04,247968,246560,1600,1600,0
2021-05-20,SD,13,PL21,73086,72481,982,352,630
2021-01-08,HO,18,PL32,66224,66224,0,0,0
2021-02-27,SD,13,PL19,60906,60366,830,192,638
2021-07-16,HO,18,PL33,66224,66224,0,0,0
2021-02-04,PW,26,PL37,786384,770208,17088,17088,0
2021-03-11,HO,18,PL11,66200,66280,0,0,0
2021-03-22,NT,16,PL51,470656,470080,960,960,0
2021-01-20,NT,16,PL51,0,0,864,864,0
2021-01-12,HO,18,PL10,54168,54112,128,128,0
2021-06-01,RT,21,PL05,208152,207528,576,576,0
2021-02-13,HO,18,PL09,72200,72112,88,88,0
2021-12-20,PRG,12,PL14,392928,391872,1248,1248,0
2021-07-21,HO,18,PL01,63424,63096,328,328,0
2021-05-03,RA,17,PL34,159504,155976,4944,4944,0
2021-11-30,SD,13,PL17,8352,8105,1111,864,247
2021-02-14,CH,24,PL04,164528,164304,224,224,0
2021-06-06,SD,13,PL17,73123,72415,1319,544,775
2021-07-04,HO,18,PL30,66128,66224,0,0,0
2021-09-06,CH,24,PL08,217529,207894,14345,4640,9705
2021-10-21,NT,16,PL51,489792,489568,960,960,0
2021-04-06,HO,18,PL09,71904,71712,232,232,0
2021-06-14,RA,17,PL34,214632,212616,2016,2016,0
2021-11-10,SD,13,PL21,12719,12587,330,192,138
2021-07-30,SD,13,PL22,76059,75942,311,208,103
2021-11-02,CH,24,PL57,34200,34112,88,88,0
2021-01-27,CL,14,PL44,233408,229632,3296,3296,0
2021-10-18,HO,18,PL30,0,0,720,720,0
2021-10-01,HO,18,PL01,67344,67048,432,432,0
2021-09-23,PR,15,PL04,264032,261952,2304,2304,0
2021-07-29,HO,18,PL09,31648,31560,88,88,0
2021-03-22,RT,21,PL42,38560,35136,3424,3424,0
2021-09-10,NT,16,PL51,500608,498304,3104,3104,0
2021-07-05,HO,18,PL40,66304,66144,160,160,0
2021-01-15,HO,18,PL33,65920,65752,240,240,0
2021-01-07,PB,25,PL55,394048,382816,36576,36576,0
2021-02-13,HO,18,PL10,56888,56800,88,88,0
2021-03-10,CH,24,PL08,220230,218295,8814,5824,2990
2021-06-27,SD,13,PL25,75397,74666,1195,464,731
2021-10-01,PR,15,PL04,262144,259840,2752,2752,0
2021-09-18,DI,19,PL53,298208,298368,32,32,0
2021-06-02,DI,19,PL53,180576,180000,800,800,0
2021-01-07,NT,16,PL51,469152,462208,7680,7680,0
2021-04-11,HO,18,PL33,66224,66224,0,0,0
2021-08-10,CA,23,PL02,189576,189696,768,768,0
2021-11-17,EC,10,PL43,628560,627600,624,624,0
2021-01-05,SD,13,PL25,64555,64280,643,368,275
2021-01-06,SD,13,PL21,72242,70675,1596,0,1596
2021-04-19,HO,18,PL10,32536,32616,88,88,0
2021-06-23,CH,24,PL08,307165,295408,15021,3264,11757
2021-10-15,SD,13,PL21,65708,65453,447,192,255
2021-02-22,HO,18,PL03,61272,60560,712,712,0
2021-01-16,HO,18,PL01,66176,65856,376,376,0
2021-09-25,PR,15,PL24,266880,261120,5888,5888,0
2021-08-08,HO,18,PL03,66160,65984,304,304,0
2021-03-30,SD,13,PL25,63131,62936,2867,2672,195
2021-08-18,CH,24,PL07,0,0,0,0,0
2021-11-30,SD,13,PL18,69975,69019,1399,400,999
2021-06-09,HO,18,PL30,65312,65200,112,112,0
2021-05-21,CH,24,PL08,252178,248951,14717,11328,3389
2021-05-05,CA,23,PL02,0,0,408,408,0
2021-06-13,PB,25,PL54,443136,443424,544,544,0
2021-11-29,SD,13,PL20,76361,76194,359,192,167
2021-11-09,SD,13,PL21,62413,61999,799,368,431
2021-06-15,RT,21,PL42,135072,122592,12480,12480,0
2021-02-11,RA,17,PL35,222216,221640,744,744,0
2021-03-10,SD,13,PL22,63076,62932,1719,1504,215
2021-05-26,SD,13,PL20,73994,73818,944,768,176
2021-07-21,PR,15,PL12,52864,51616,1424,1424,0
2021-08-01,HO,18,PL01,66200,65408,872,872,0
2021-08-09,RA,17,PL34,221448,221424,312,312,0
2021-09-16,SD,13,PL20,73489,73479,442,384,58
2021-02-11,HO,18,PL09,72344,72280,112,112,0
2021-11-02,CL,14,PL45,287936,283104,3712,3712,0
2021-06-10,SD,13,PL17,73351,71200,2786,592,2194
2021-07-22,SD,13,PL19,66330,66312,222,192,30
2021-11-23,NT,16,PL51,471328,470848,1184,1184,0
2021-01-17,CA,23,PL02,235704,231912,4152,4152,0
2021-01-29,CH,24,PL08,269159,255920,24759,10560,14199
2021-04-26,CH,24,PL12,116096,115744,352,352,0
2021-05-01,CA,23,PL31,234792,232992,2496,2496,0
2021-09-11,HO,18,PL33,132288,132048,240,240,0
2021-01-23,PW,26,PL37,518880,487104,32640,32640,0
2021-11-19,CA,23,PL02,225504,225576,432,432,0
2021-02-04,HO,18,PL09,70768,70544,224,224,0
2021-06-19,HO,18,PL32,67200,66952,256,256,0
2021-04-23,SD,13,PL25,8852,8841,475,464,11
2021-11-23,SD,13,PL18,26067,25792,1273,528,745
2021-05-05,CL,14,PL45,82176,73504,5248,5248,0
2021-05-07,HO,18,PL40,64744,64544,304,304,0
2021-08-02,RA,17,PL34,221880,221544,648,648,0
2021-11-30,RA,17,PL34,181656,180408,2376,2376,0
2021-04-11,RA,17,PL34,215328,214152,1176,1176,0
2021-03-08,SD,13,PL22,72544,72494,528,432,96
2021-12-13,PR,15,PL24,262208,259680,3040,3040,0
2021-03-04,CH,24,PL08,284987,281926,11853,8576,3277
2021-06-14,SB,11,PL50,444288,442464,2432,2432,0
2021-11-16,SB,11,PL36,172512,161664,11016,11016,0
2021-11-16,SD,13,PL25,75216,74227,1167,176,991
2021-06-04,HO,18,PL30,65208,65176,128,128,0
2021-11-07,CH,24,PL57,34072,34056,44,44,0
2021-01-02,CA,23,PL13,51336,49184,2152,2152,0
2021-01-06,DI,19,PL52,296928,297024,352,352,0
2021-01-27,SD,13,PL25,62849,62371,1726,1248,478
2021-09-12,CL,14,PL44,299232,296032,2624,2624,0
2021-12-12,HO,18,PL10,68608,68584,96,96,0
2021-10-06,HO,18,PL09,64480,64352,312,312,0
2021-02-14,SD,13,PL17,68854,67009,2360,400,1960
2021-03-10,DI,19,PL52,258912,258528,1088,1088,0
2021-05-05,HO,18,PL40,65368,65272,96,96,0
2021-11-13,HO,18,PL40,66064,65800,280,280,0
2021-02-09,RA,17,PL35,207384,207192,768,768,0
2021-05-01,SB,11,PL36,131256,129000,2616,2616,0
2021-01-04,RA,17,PL35,193872,189768,4272,4272,0
2021-11-12,PB,25,PL54,413024,367168,47552,47552,0
2021-03-05,CA,23,PL31,222264,215808,6672,6672,0
2021-11-26,CL,14,PL45,243904,239296,2240,2240,0
2021-10-30,SD,13,PL21,40559,40426,1158,944,214
2021-10-15,HO,18,PL09,67048,67024,272,272,0
2021-05-03,HO,18,PL40,68424,68488,0,0,0
2021-04-09,DI,19,PL53,291904,292416,448,448,0
2021-08-16,HO,18,PL56,54544,54336,264,264,0
2021-04-11,RT,21,PL06,205680,205416,552,552,0
2021-07-18,SD,13,PL20,72749,72792,576,544,32
2021-05-02,CA,23,PL31,235440,235392,360,360,0
2021-12-21,PRG,12,PL14,393248,392288,1376,1376,0
2021-12-14,HO,18,PL32,50888,50392,496,496,0
2021-06-30,RA,17,PL34,222168,221832,576,576,0
2021-01-31,SB,11,PL36,313752,313248,1392,1392,0
2021-04-04,RT,21,PL42,174560,157856,16704,16704,0
2021-01-13,HO,18,PL09,3192,3184,8,8,0
2021-06-15,RA,17,PL34,221544,220968,792,792,0
2021-01-19,HO,18,PL03,63224,63072,296,296,0
2021-09-29,PB,25,PL54,128672,123936,14144,14144,0
2021-11-23,HO,18,PL10,68120,68064,88,88,0
2021-10-06,CH,24,PL57,22764,22720,44,44,0
2021-07-07,HO,18,PL32,67488,67400,224,224,0
2021-09-01,RA,17,PL34,136824,135096,2040,2040,0
2021-03-13,CH,24,PL12,106400,99136,7360,7360,0
2021-02-18,HO,18,PL11,59160,58704,456,456,0
2021-05-27,SD,13,PL22,67818,67403,2125,896,1229
2021-12-03,CH,24,PL08,167254,162269,23105,18048,5057
2021-04-13,HO,18,PL32,4056,4056,0,0,0
2021-08-06,CA,23,PL02,28272,28416,864,864,0
2021-09-24,SB,11,PL36,48912,48672,240,240,0
2021-02-15,EC,10,PL43,558624,555072,2928,2928,0
2021-05-18,HO,18,PL33,66216,66224,0,0,0
2021-03-14,CH,24,PL12,162864,163056,240,240,0
2021-06-20,CL,14,PL45,260896,257344,3744,3744,0
2021-09-11,CH,24,PL57,33864,33848,44,44,0
2021-10-08,SD,13,PL18,69991,68882,1347,192,1155
2021-02-11,CH,24,PL08,164672,161920,4448,4448,0
2021-02-08,HO,18,PL01,35632,35184,2616,2616,0
2021-07-07,SD,13,PL18,30017,29926,635,544,91
2021-11-01,RT,21,PL42,140848,137312,3536,3536,0
2021-03-21,CA,23,PL13,85144,85096,88,88,0
2021-03-09,RA,17,PL34,215736,215352,744,744,0
2021-05-26,NT,16,PL51,466336,465536,1600,1600,0
2021-11-26,RT,21,PL05,160512,158208,3696,3696,0
2021-08-05,EC,10,PL43,629808,629280,576,576,0
2021-02-02,CH,24,PL08,277701,262868,20786,5824,14962
2021-12-14,RT,21,PL42,158960,131680,27488,27488,0
2021-12-11,PB,25,PL55,446880,446400,1024,1024,0
2021-03-07,RT,21,PL42,182032,173328,10816,10816,0
2021-06-03,HO,18,PL30,57120,56928,192,192,0
2021-01-05,RA,17,PL34,214392,212160,2424,2424,0
2021-06-07,DI,19,PL53,296576,296032,864,864,0
2021-11-07,PB,25,PL54,439392,438016,3520,3520,0
2021-09-19,RT,21,PL06,205200,203952,1248,1248,0
2021-03-29,CA,23,PL02,157512,156312,1200,1200,0
2021-11-25,CH,24,PL12,162992,162912,352,352,0
2021-06-23,PR,15,PL04,262720,257536,5696,5696,0
2021-10-01,CH,24,PL07,204646,201697,12741,9792,2949
2021-10-09,HO,18,PL11,66240,66128,112,112,0
2021-12-14,HO,18,PL11,66240,65920,320,320,0
2021-12-13,SD,13,PL17,15953,15885,567,368,199
2021-07-11,HO,18,PL03,53496,53360,136,136,0
2021-12-11,EC,10,PL43,612528,610992,1968,1968,0
2021-05-18,CH,24,PL12,163808,163696,320,320,0
2021-09-28,HO,18,PL32,56624,56464,232,232,0
2021-05-29,DI,19,PL52,286848,285024,2496,2496,0
2021-07-19,CL,14,PL45,282624,275648,6112,6112,0
2021-01-25,HO,18,PL32,63536,62144,1400,1400,0
2021-08-12,HO,18,PL40,63776,63168,808,808,0
2021-11-03,DI,19,PL52,260672,256672,5024,5024,0
2021-01-29,CA,23,PL31,234408,233112,1800,1800,0
2021-10-14,SB,11,PL36,265440,252528,13296,13296,0
2021-03-09,NT,16,PL57,154480,154208,352,352,0
2021-07-23,RT,21,PL42,183008,163904,19952,19952,0
2021-11-11,HO,18,PL56,66048,65888,160,160,0
2021-03-29,PB,25,PL55,449376,448960,704,704,0
2021-02-06,CH,24,PL04,164176,163648,528,528,0
2021-09-23,RT,21,PL41,49136,48688,448,448,0
2021-10-06,RT,21,PL05,173112,173064,13128,13128,0
2021-03-25,CA,23,PL02,148128,144432,4200,4200,0
2021-03-05,CH,24,PL04,146448,146352,1120,1120,0
2021-06-26,HO,18,PL40,66320,66320,0,0,0
2021-01-04,SD,13,PL18,66916,65837,2003,848,1155
2021-11-05,SD,13,PL19,71695,71612,314,176,138
2021-02-16,RT,21,PL42,135904,123536,12368,12368,0
2021-06-22,SD,13,PL22,62943,61199,1952,208,1744
2021-02-10,CA,23,PL13,81776,81664,248,248,0
2021-07-10,SD,13,PL20,76341,76293,255,176,79
2021-01-03,SD,13,PL20,71800,70969,1376,544,832
2021-03-06,SB,11,PL36,313680,313608,816,816,0
2021-10-02,DI,19,PL53,298208,298432,0,0,0
2021-11-18,HO,18,PL32,56856,56536,320,320,0
2021-02-08,HO,18,PL03,62936,62680,288,288,0
2021-05-20,RA,17,PL34,171264,170808,2376,2376,0
2021-01-14,HO,18,PL10,34488,34416,72,72,0
2021-05-27,HO,18,PL32,67608,67512,96,96,0
2021-09-19,HO,18,PL01,67272,67120,280,280,0
2021-04-26,RT,21,PL05,179688,179808,552,552,0
2021-07-09,SD,13,PL25,75082,74618,660,176,484
2021-02-07,HO,18,PL33,67976,67392,584,584,0
2021-12-09,EC,10,PL43,537888,533904,4224,4224,0
2021-11-10,CH,24,PL57,34056,33972,88,88,0
2021-05-26,RT,21,PL06,203664,202392,1512,1512,0
2021-05-15,SD,13,PL17,64521,62999,3685,2144,1541
2021-09-23,CH,24,PL07,298801,296110,10371,7680,2691
2021-03-03,RT,21,PL06,206376,206304,288,288,0
2021-06-02,CA,23,PL02,224568,214776,9816,9816,0
2021-07-13,SD,13,PL20,55630,55517,817,704,113
2021-11-28,EC,10,PL43,584448,573936,10512,10512,0
2021-11-01,RA,17,PL34,255216,252624,2832,2832,0
2021-03-30,PR,15,PL04,256608,254816,1792,1792,0
2021-03-22,CH,24,PL07,312423,298705,15855,1984,13871
2021-08-24,RT,21,PL05,173304,164232,9072,9072,0
2021-03-21,HO,18,PL09,70688,70232,456,456,0
2021-05-24,HO,18,PL03,66376,66320,136,136,0
2021-09-22,HO,18,PL09,65320,65232,88,88,0
2021-07-12,PW,26,PL37,72288,71808,3024,3024,0
2021-04-15,CL,14,PL44,297280,276736,2592,2592,0
2021-10-19,HO,18,PL30,0,0,1008,1008,0
2021-09-26,RA,17,PL35,227856,226320,1536,1536,0
2021-10-02,DI,19,PL52,293408,293760,0,0,0
2021-09-26,SD,13,PL18,73904,73214,1438,672,766
2021-12-12,SD,13,PL17,60030,59270,1289,528,761
2021-10-29,CH,24,PL08,99,68,4447,4416,31
2021-02-24,CL,14,PL45,304512,286272,3232,3232,0
2021-12-23,HO,18,PL32,16088,16088,8,8,0
2021-06-20,SB,11,PL36,308976,307080,2088,2088,0
2021-12-03,HO,18,PL30,147424,145968,1456,1456,0
2021-05-18,SD,13,PL21,72868,72075,1145,352,793
2021-11-24,PR,15,PL04,265536,264896,640,640,0
2021-01-09,EC,10,PL43,618384,616416,1824,1824,0
2021-02-05,SD,13,PL22,55065,54919,363,192,171
2021-03-22,CA,23,PL31,230712,228288,2784,2784,0
2021-02-08,SD,13,PL17,66610,65357,3274,1888,1386
2021-02-16,PB,25,PL55,430976,424000,7968,7968,0
2021-09-19,CA,23,PL31,207072,205368,2016,2016,0
2021-10-11,HO,18,PL33,132256,131920,336,336,0
2021-11-30,SB,11,PL36,79296,78984,480,480,0
2021-01-29,CA,23,PL02,198432,184296,14976,14976,0
2021-09-09,CH,24,PL07,89408,87552,2304,2304,0
2021-09-15,HO,18,PL56,65736,65432,344,344,0
2021-09-24,PW,26,PL37,814416,809952,5808,5808,0
2021-01-23,SD,13,PL21,73220,71230,2166,176,1990
2021-11-25,HO,18,PL30,53488,51200,2896,2896,0
2021-10-13,RT,21,PL41,140832,107616,33216,33216,0
2021-09-07,CL,14,PL44,288576,283936,4512,4512,0
2021-03-23,RA,17,PL56,221520,219504,2112,2112,0
2021-05-28,HO,18,PL03,64448,64320,168,168,0
2021-05-05,RT,21,PL06,179904,179592,2688,2688,0
2021-08-11,CH,24,PL57,34068,34024,44,44,0
2021-04-29,CH,24,PL08,181134,169362,16284,4512,11772
2021-11-20,HO,18,PL11,63920,63832,248,248,0
2021-04-11,SD,13,PL21,71845,71573,448,176,272
2021-05-30,SD,13,PL19,72599,72637,405,352,53
2021-08-30,CA,23,PL31,198576,196800,2088,2088,0
2021-04-13,RT,21,PL41,0,0,416,416,0
2021-10-28,RT,21,PL06,205080,202680,2664,2664,0
2021-11-15,CL,14,PL44,191744,175200,15456,15456,0
2021-06-15,HO,18,PL32,68328,67408,920,920,0
2021-07-31,HO,18,PL01,67320,66760,560,560,0
2021-05-29,SD,13,PL22,57588,57164,824,400,424
2021-07-21,SD,13,PL22,75682,75424,482,224,258
2021-07-18,RT,21,PL05,208656,208656,0,0,0
2021-08-16,NT,16,PL51,229312,225056,5152,5152,0
2021-03-29,HO,18,PL09,50840,49656,1568,1568,0
2021-10-03,CH,24,PL07,313060,307023,13330,6912,6418
2021-09-05,HO,18,PL03,66448,66272,240,240,0
2021-03-08,HO,18,PL32,67640,67560,152,152,0
2021-11-16,CH,24,PL07,220963,207389,19942,6368,13574
2021-11-09,NT,16,PL51,496800,493344,4224,4224,0
2021-04-07,RA,17,PL56,217296,216984,312,312,0
2021-12-16,SD,13,PL18,62348,61695,3005,2352,653
2021-08-27,CH,24,PL07,268379,262465,19574,13600,5974
2021-11-21,PB,25,PL54,413792,409984,3808,3808,0
2021-02-19,DI,19,PL52,298848,293696,5888,5888,0
2021-06-01,SD,13,PL25,33635,32236,1591,192,1399
2021-07-30,SD,13,PL17,68717,67693,1890,848,1042
2021-06-30,SB,11,PL50,450656,449632,2368,2368,0
2021-01-06,PB,25,PL55,443328,439296,8704,8704,0
2021-06-28,CH,24,PL07,240816,234814,9835,3584,6251
2021-10-26,RT,21,PL42,47904,46464,41344,41344,0
2021-10-21,RT,21,PL06,166440,162096,4680,4680,0
2021-01-17,NT,16,PL51,461632,459872,2944,2944,0
2021-01-06,HO,18,PL09,66208,66264,0,0,0
2021-07-16,PB,25,PL55,396096,362976,34240,34240,0
2021-04-30,CH,24,PL08,300626,282993,25257,7072,18185
2021-07-29,PRG,12,PL14,0,0,9920,9920,0
2021-04-23,HO,18,PL30,63432,63368,112,112,0
2021-04-13,SD,13,PL18,72369,72058,758,368,390
2021-12-07,CH,24,PL12,163184,162256,1312,1312,0
2021-07-12,PR,15,PL24,166144,166144,64,64,0
2021-11-12,SD,13,PL18,69846,68964,1698,800,898
2021-06-24,CA,23,PL11,235896,234648,1464,1464,0
2021-06-16,RT,21,PL05,178632,178008,648,648,0
2021-04-10,PR,15,PL04,267200,266656,672,672,0
2021-04-07,RA,17,PL34,220656,220320,312,312,0
2021-03-06,SB,11,PL50,451904,450240,2688,2688,0
2021-04-27,HO,18,PL33,60264,60112,224,224,0
2021-07-24,RA,17,PL34,10248,10248,0,0,0
2021-05-30,PW,26,PL37,804960,802800,4128,4128,0
2021-04-25,PRG,12,PL14,382176,381888,864,864,0
2021-01-06,RA,17,PL56,221784,221184,792,792,0
2021-11-28,RA,17,PL34,216096,214512,1584,1584,0
2021-02-23,PRG,12,PL12,379744,378848,896,896,0
2021-11-02,SD,13,PL17,68024,67760,680,416,264
2021-07-20,SD,13,PL19,59140,59095,749,704,45
2021-09-04,HO,18,PL56,65952,65560,392,392,0
2021-10-02,CH,24,PL57,34200,34152,48,48,0
2021-10-11,CA,23,PL13,44664,44744,216,216,0
2021-07-03,SB,11,PL36,304848,301680,3624,3624,0
2021-11-05,RA,17,PL35,261072,259032,2040,2040,0
2021-09-24,PR,15,PL24,267104,267040,896,896,0
2021-09-30,PR,15,PL04,263104,261792,1952,1952,0
2021-12-01,SD,13,PL17,56845,56400,5645,5200,445
2021-04-09,CL,14,PL44,226144,212960,7136,7136,0
2021-01-11,SD,13,PL20,74401,73364,1876,752,1124
2021-02-17,EC,10,PL43,618144,617088,3312,3312,0
2021-11-07,SD,13,PL21,62662,62484,562,384,178
2021-02-17,SB,11,PL50,440032,434208,6560,6560,0
2021-03-05,HO,18,PL09,72128,71648,480,480,0
2021-11-29,CL,14,PL45,283776,277696,5088,5088,0
2021-10-31,SD,13,PL19,75912,75767,571,368,203
2021-04-17,EC,10,PL43,488784,484896,3696,3696,0
2021-01-30,HO,18,PL30,65376,65264,200,200,0
2021-07-15,PB,25,PL55,445184,431616,14240,14240,0
2021-04-20,HO,18,PL01,66152,65944,208,208,0
2021-02-20,HO,18,PL33,68712,68624,88,88,0
2021-11-12,PRG,12,PL12,385760,383104,2976,2976,0
2021-04-19,SD,13,PL20,0,0,130,0,130
2021-06-13,PR,15,PL04,264768,263552,1376,1376,0
2021-09-25,PRG,12,PL14,388576,388256,1120,1120,0
2021-06-03,PR,15,PL24,260384,259456,1088,1088,0
2021-12-16,HO,18,PL32,53880,53672,320,320,0
2021-04-16,SD,13,PL25,68329,68283,254,208,46
2021-10-03,HO,18,PL09,64936,64936,144,144,0
2021-06-02,PR,15,PL12,127616,126608,1008,1008,0
2021-05-12,HO,18,PL40,48880,48864,16,16,0
2021-10-11,SB,11,PL36,212232,208416,4248,4248,0
2021-09-14,CA,23,PL02,225360,224904,960,960,0
2021-02-12,NT,16,PL51,406080,404416,3328,3328,0
2021-12-20,SD,13,PL18,67329,66374,1147,192,955
2021-06-27,CL,14,PL45,298272,296064,1856,1856,0
2021-04-17,PR,15,PL57,111072,110464,832,832,0
2021-09-17,PR,15,PL04,0,0,256,256,0
2021-02-10,HO,18,PL10,55952,55904,88,88,0
2021-05-08,RT,21,PL06,207864,207000,984,984,0
2021-10-07,SD,13,PL18,72725,72182,937,368,569
2021-01-25,CL,14,PL44,294016,285952,3520,3520,0
2021-06-16,RT,21,PL42,3120,2672,9024,9024,0
2021-02-24,NT,16,PL51,269152,265184,3968,3968,0
2021-06-15,CA,23,PL31,178680,177576,2136,2136,0
2021-09-01,CH,24,PL08,313671,304959,11374,2592,8782
2021-12-01,HO,18,PL32,57648,57648,0,0,0
2021-11-22,CA,23,PL02,186144,186240,576,576,0
2021-05-15,HO,18,PL40,64520,64280,240,240,0
2021-04-01,HO,18,PL11,66288,66288,0,0,0
2021-04-15,SD,13,PL18,55887,55685,2980,2752,228
2021-05-27,CL,14,PL44,281696,268704,12480,12480,0
2021-10-29,CL,14,PL45,100704,99456,960,960,0
2021-12-11,CA,23,PL35,75536,72664,2920,2920,0
2021-06-26,SB,11,PL36,316032,315048,1272,1272,0
2021-02-12,EC,10,PL43,619008,618240,1104,1104,0
2021-07-04,PR,15,PL04,268000,267264,736,736,0
2021-08-10,SD,13,PL18,74156,73876,1224,944,280
2021-10-12,CA,23,PL13,51776,51448,432,432,0
2021-09-28,PW,26,PL37,816000,816912,1248,1248,0
2021-09-17,HO,18,PL32,56368,56168,200,200,0
2021-04-14,HO,18,PL10,56848,56752,200,200,0
2021-09-04,SD,13,PL19,74780,74725,423,368,55
2021-09-07,CH,24,PL07,190225,183123,21181,13536,7645
2021-07-23,RA,17,PL34,216552,215640,1032,1032,0
2021-12-06,HO,18,PL03,65248,65096,200,200,0
2021-03-06,HO,18,PL01,66152,65928,224,224,0
2021-03-23,DI,19,PL52,295040,295520,832,832,0
2021-01-20,SD,13,PL21,73231,71798,1625,192,1433
2021-04-13,SB,11,PL50,445728,442240,4256,4256,0
2021-06-15,CA,23,PL02,225624,222984,2760,2760,0
2021-02-22,RA,17,PL35,217632,215544,2088,2088,0
2021-04-28,HO,18,PL01,65192,64568,680,680,0
2021-09-09,DI,19,PL52,160512,156032,5024,5024,0
2021-03-26,CL,14,PL45,74592,70688,3744,3744,0
2021-12-05,RT,21,PL05,185640,184344,1464,1464,0
2021-01-20,RA,17,PL34,217944,214296,3672,3672,0
2021-05-10,CH,24,PL12,163072,163168,208,208,0
2021-04-23,CH,24,PL08,295147,290412,8543,3808,4735
2021-05-31,PRG,12,PL14,392224,391872,896,896,0
2021-12-09,RT,21,PL05,77856,71928,5928,5928,0
2021-01-18,CH,24,PL08,273515,261248,23318,11008,12310
2021-03-02,SD,13,PL21,64848,64351,2531,1984,547
2021-01-10,SD,13,PL21,70252,69416,1204,368,836
2021-11-18,RT,21,PL42,64448,67872,1696,1696,0
2021-05-31,RA,17,PL35,223128,221376,1872,1872,0
2021-10-23,CH,24,PL12,132656,132192,480,480,0
2021-01-21,RT,21,PL05,202296,199776,2784,2784,0
2021-02-07,EC,10,PL43,629952,630000,576,576,0
2021-01-20,RT,21,PL05,174024,173232,2928,2928,0
2021-05-27,PR,15,PL04,36352,33152,5120,5120,0
2021-07-19,HO,18,PL01,67320,66800,520,520,0
2021-01-18,NT,16,PL51,22976,22976,0,0,0
2021-06-10,NT,16,PL51,446112,442528,4096,4096,0
2021-12-06,HO,18,PL10,66032,65688,416,416,0
2021-08-04,HO,18,PL33,54696,53632,1064,1064,0
2021-09-28,CL,14,PL44,283360,274752,8256,8256,0
2021-12-09,CH,24,PL12,164432,164400,304,304,0
2021-01-24,HO,18,PL10,35152,33760,1584,1584,0
2021-02-19,CA,23,PL02,237024,236304,936,936,0
2021-06-08,DI,19,PL53,293120,292192,1376,1376,0
2021-07-21,RT,21,PL05,207816,207528,336,336,0
2021-10-18,CH,24,PL07,0,0,10110,3808,6302
2021-03-10,SD,13,PL21,71974,71472,791,192,599
2021-11-01,CA,23,PL02,180840,181008,720,720,0
2021-05-06,HO,18,PL09,72344,72168,176,176,0
2021-10-29,CH,24,PL57,7316,7252,64,64,0
2021-07-06,RT,21,PL06,66384,66528,2496,2496,0
2021-10-14,SD,13,PL19,73791,73652,491,352,139
2021-02-13,HO,18,PL03,66216,66080,152,152,0
2021-09-25,NT,16,PL51,514816,515136,384,384,0
2021-07-04,CA,23,PL31,230808,230712,384,384,0
2021-11-15,HO,18,PL11,7560,7304,256,256,0
2021-03-18,PR,15,PL04,262208,262016,992,992,0
2021-07-02,PB,25,PL54,416192,410720,6784,6784,0
2021-08-04,SD,13,PL25,15503,14532,1499,528,971
2021-01-22,CA,23,PL13,75488,75416,456,456,0
2021-05-20,HO,18,PL10,55784,55600,184,184,0
2021-02-22,CL,14,PL45,196416,184544,1056,1056,0
2021-01-03,PR,15,PL04,244864,244960,640,640,0
2021-02-06,SD,13,PL19,64967,64308,851,192,659
2021-02-14,SD,13,PL20,72279,71964,713,384,329
2021-10-20,PB,25,PL54,423584,414112,11776,11776,0
2021-01-23,SD,13,PL19,61515,61323,594,368,226
2021-07-23,RT,21,PL41,1552,944,608,608,0
2021-11-27,RT,21,PL06,202608,202512,504,504,0
2021-02-11,SD,13,PL20,69678,69103,1311,736,575
2021-05-01,SD,13,PL21,72437,72085,780,352,428
2021-03-29,SD,13,PL18,62551,60789,3245,1376,1869
2021-06-22,CL,14,PL45,203232,201120,1760,1760,0
2021-11-08,DI,19,PL52,290752,289760,2080,2080,0
2021-02-18,CH,24,PL04,163904,163856,240,240,0
2021-03-22,HO,18,PL32,45864,45832,32,32,0
2021-04-14,HO,18,PL33,66224,66224,0,0,0
2021-06-07,PR,15,PL04,262560,252736,10112,10112,0
2021-01-29,NT,16,PL51,458080,451328,7456,7456,0
2021-04-30,HO,18,PL03,66216,66152,136,136,0
2021-05-20,EC,10,PL43,616224,614976,1872,1872,0
2021-07-13,CL,14,PL45,295584,291264,3744,3744,0
2021-10-09,PB,25,PL55,424352,418432,7104,7104,0
2021-07-15,HO,18,PL33,61936,61784,192,192,0
2021-11-10,RA,17,PL34,257760,252120,5904,5904,0
2021-02-13,HO,18,PL01,48224,47896,328,328,0
2021-07-24,CL,14,PL45,13504,13440,2880,2880,0
2021-01-06,CA,23,PL02,118872,116376,5520,5520,0
2021-03-30,CH,24,PL07,302490,293100,13422,4032,9390
2021-06-09,SB,11,PL36,269520,262008,7896,7896,0
2021-07-06,SD,13,PL19,66294,66246,304,176,128
2021-01-13,EC,10,PL43,607488,605280,2832,2832,0
2021-07-04,SD,13,PL17,61980,60356,6104,4480,1624
2021-06-24,RA,17,PL35,221496,219672,1776,1776,0
2021-02-20,SD,13,PL19,64329,64195,774,640,134
2021-05-17,HO,18,PL40,67224,67184,96,96,0
2021-03-17,PW,26,PL37,796848,792864,6048,6048,0
2021-09-27,SD,13,PL22,76555,76587,233,192,41
2021-10-08,SD,13,PL20,76422,75797,801,176,625
2021-11-18,CH,24,PL24,149024,147200,2256,2256,0
2021-07-03,RA,17,PL35,140016,131952,8496,8496,0
2021-12-10,RT,21,PL42,7728,0,7728,7728,0
2021-02-05,SD,13,PL21,47538,46067,2952,624,2328
2021-11-04,CH,24,PL08,259592,255314,10580,6240,4340
2021-02-13,RT,21,PL06,204336,204168,264,264,0
2021-07-12,CA,23,PL11,222960,222264,792,792,0
2021-09-17,CL,14,PL44,290272,267008,9216,9216,0
2021-02-12,SD,13,PL18,73858,73332,826,192,634
2021-12-16,SD,13,PL19,67083,66780,687,384,303
2021-11-29,SD,13,PL25,62372,59748,2800,176,2624
2021-02-02,PR,15,PL57,47200,46240,1088,1088,0
2021-01-27,PRG,12,PL14,392864,391520,1728,1728,0
2021-12-17,CH,24,PL08,276760,274714,20562,18432,2130
2021-08-12,CH,24,PL57,34096,34040,56,56,0
2021-06-16,SD,13,PL18,36666,34964,7114,5424,1690
2021-08-02,CL,14,PL44,297728,295840,1728,1728,0
2021-09-25,SD,13,PL17,70551,70286,841,576,265
2021-05-28,PR,15,PL04,262816,262528,352,352,0
2021-03-05,CL,14,PL45,247328,228000,10208,10208,0
2021-05-09,CH,24,PL57,34212,34188,48,48,0
2021-06-01,HO,18,PL30,66080,65816,176,176,0
2021-12-21,CA,23,PL02,233880,232440,1824,1824,0
2021-08-23,SD,13,PL20,71091,70986,490,368,122
2021-02-15,RT,21,PL42,103728,100768,3040,3040,0
2021-05-12,PB,25,PL55,300384,276160,27040,27040,0
2021-09-29,HO,18,PL01,67048,66608,440,440,0
2021-03-18,CA,23,PL31,232488,231768,1080,1080,0
2021-08-10,HO,18,PL03,67600,67600,0,0,0
2021-10-02,SD,13,PL22,70864,70861,823,736,87
2021-05-02,HO,18,PL30,66224,66224,0,0,0
2021-07-03,CA,23,PL11,159312,156360,3120,3120,0
2021-07-24,DI,19,PL53,0,0,0,0,0
2021-09-09,EC,10,PL43,508560,496176,11904,11904,0
2021-11-22,SD,13,PL19,57774,57583,1919,1712,207
2021-02-19,SD,13,PL18,70546,69725,1142,256,886
2021-02-02,RT,21,PL05,207216,207360,312,312,0
2021-07-10,CA,23,PL31,229128,228960,744,744,0
2021-10-03,CH,24,PL57,34184,34164,44,44,0
2021-11-30,CH,24,PL57,16168,16056,172,172,0
2021-05-13,HO,18,PL01,0,0,808,808,0
2021-09-15,RT,21,PL06,187296,185976,1512,1512,0
2021-06-04,PR,15,PL12,138992,138848,192,192,0
2021-09-20,SD,13,PL25,76197,75621,757,192,565
2021-09-14,SD,13,PL21,75245,74906,1731,1392,339
2021-11-27,CA,23,PL02,164856,164112,1320,1320,0
2021-06-23,SD,13,PL17,73243,71808,2079,560,1519
2021-09-16,HO,18,PL10,69248,69248,0,0,0
2021-11-18,RA,17,PL34,260832,257736,2736,2736,0
2021-10-01,CA,23,PL02,1824,0,1824,1824,0
2021-11-21,SD,13,PL18,76035,75591,876,432,444
2021-12-06,PW,26,PL37,789072,788880,5328,5328,0
2021-02-14,EC,10,PL43,626448,625296,1008,1008,0
2021-05-07,CA,23,PL02,6216,4416,1824,1824,0
2021-10-15,CH,24,PL07,125572,123950,26412,20128,6284
2021-11-17,RT,21,PL41,129776,126320,3504,3504,0
2021-12-16,HO,18,PL01,67576,66656,976,976,0
2021-05-21,SD,13,PL21,68431,67928,2119,1616,503
2021-08-05,SB,11,PL36,283344,270816,12528,12528,0
2021-12-09,CA,23,PL31,225144,221760,3480,3480,0
2021-11-19,CL,14,PL44,0,0,5152,5152,0
2021-04-09,HO,18,PL03,65320,65304,144,144,0
2021-02-28,EC,10,PL43,597744,598128,1248,1248,0
2021-03-18,HO,18,PL01,66160,66040,120,120,0
2021-10-14,PB,25,PL55,448032,413504,34688,34688,0
2021-07-08,CL,14,PL44,300480,297056,640,640,0
2021-05-12,HO,18,PL33,62704,62576,128,128,0
2021-07-01,CA,23,PL57,22528,22348,196,196,0
2021-06-04,RT,21,PL06,207528,207648,264,264,0
2021-12-22,HO,18,PL30,47312,38960,8352,8352,0
2021-03-25,PR,15,PL24,266080,266048,576,576,0
2021-02-09,SD,13,PL25,66890,65589,2106,720,1386
2021-01-18,RA,17,PL56,161400,161496,2040,2040,0
2021-05-06,CH,24,PL12,163504,163504,400,400,0
2021-10-08,PR,15,PL24,266752,266560,832,832,0
2021-10-31,PW,26,PL37,783264,776400,8544,8544,0
2021-10-26,HO,18,PL30,12832,9008,7648,7648,0
2021-01-14,RA,17,PL56,219432,218928,504,504,0
2021-02-11,SD,13,PL25,73575,72037,1751,176,1575
2021-07-03,SD,13,PL20,55155,54668,1351,864,487
2021-02-06,CA,23,PL02,227448,223296,4320,4320,0
2021-05-03,NT,16,PL51,469184,469152,416,416,0
2021-09-04,CH,24,PL07,306313,301540,8585,3744,4841
2021-11-07,CH,24,PL24,163040,163184,368,368,0
2021-09-07,RA,17,PL35,232440,232272,528,528,0
2021-07-11,SD,13,PL19,48896,48934,786,752,34
2021-02-10,RT,21,PL06,167952,167880,4968,4968,0
2021-06-29,PR,15,PL12,139264,139248,224,224,0
2021-03-27,RA,17,PL34,104880,101184,3912,3912,0
2021-03-19,HO,18,PL03,66224,66224,0,0,0
2021-09-23,SD,13,PL18,74201,73874,711,384,327
2021-03-04,DI,19,PL52,299264,299680,0,0,0
2021-09-18,SD,13,PL20,73362,73329,49,16,33
2021-11-13,HO,18,PL10,69432,69432,0,0,0
2021-01-10,SB,11,PL50,399008,393632,5984,5984,0
2021-05-28,EC,10,PL43,463680,457920,6528,6528,0
2021-06-21,CA,23,PL31,231120,227280,3840,3840,0
2021-07-07,HO,18,PL33,66120,65960,160,160,0
2021-02-02,RA,17,PL34,29376,28632,3840,3840,0
2021-05-25,CH,24,PL57,19696,19628,52,52,0
2021-09-07,RT,21,PL42,190576,189712,960,960,0
2021-11-07,CA,23,PL13,83728,83880,176,176,0
2021-11-26,CH,24,PL07,116182,114126,11368,9312,2056
2021-07-26,SD,13,PL25,49307,48778,2609,2080,529
2021-09-09,DI,19,PL53,294304,293952,352,352,0
2021-05-21,RT,21,PL06,152712,149976,5736,5736,0
2021-09-16,RA,17,PL35,183216,180048,3168,3168,0
2021-07-10,PB,25,PL55,448800,445600,3552,3552,0
2021-10-17,RT,21,PL41,167808,150528,17280,17280,0
2021-06-22,SB,11,PL50,408672,407584,6368,6368,0
2021-09-30,SD,13,PL19,75735,75452,507,224,283
2021-05-26,HO,18,PL03,67584,67584,0,0,0
2021-09-02,SB,11,PL50,436160,430912,6656,6656,0
2021-05-20,PB,25,PL55,269984,266592,3808,3808,0
2021-11-22,EC,10,PL43,623952,623040,624,624,0
2021-10-10,PB,25,PL54,391680,358112,34880,34880,0
2021-02-14,HO,18,PL30,44896,44856,280,280,0
2021-09-22,SB,11,PL50,449056,448448,1952,1952,0
2021-02-01,PR,15,PL24,266368,259648,6816,6816,0
2021-04-22,HO,18,PL09,65656,64264,1392,1392,0
2021-01-07,RA,17,PL34,7320,0,7320,7320,0
2021-10-25,PB,25,PL55,449920,449216,1248,1248,0
2021-04-16,HO,18,PL03,66248,66248,0,0,0
2021-05-19,CL,14,PL45,293664,279456,5248,5248,0
2021-10-25,SB,11,PL36,311088,307920,3888,3888,0
2021-07-04,PB,25,PL55,446400,443040,3648,3648,0
2021-08-05,SD,13,PL17,55723,54863,2988,2048,940
2021-10-19,PB,25,PL54,440672,432384,9856,9856,0
2021-06-30,HO,18,PL32,68048,67888,160,160,0
2021-04-16,SD,13,PL18,74372,74234,506,368,138
2021-01-05,CA,23,PL13,84744,83408,1368,1368,0
2021-01-21,SD,13,PL25,68985,68313,1184,464,720
2021-01-22,HO,18,PL32,67344,67048,296,296,0
2021-03-20,RA,17,PL34,201192,198480,2712,2712,0
2021-08-11,SB,11,PL36,305904,303408,2544,2544,0
2021-11-03,PRG,12,PL12,226976,225760,2688,2688,0
2021-11-04,EC,10,PL43,632016,632256,192,192,0
2021-03-26,RT,21,PL06,167040,165144,3888,3888,0
2021-03-22,SD,13,PL25,72552,72477,656,576,80
2021-11-11,SD,13,PL22,76440,76172,466,176,290
2021-01-04,SD,13,PL19,75286,75198,687,544,143
2021-05-28,DI,19,PL52,289984,289600,1184,1184,0
2021-09-30,SB,11,PL36,268800,267744,3936,3936,0
2021-09-29,PR,15,PL04,221152,220352,1632,1632,0
2021-06-16,SB,11,PL36,182376,176640,6072,6072,0
2021-05-21,CL,14,PL45,277280,268320,8064,8064,0
2021-09-02,SD,13,PL20,69236,67902,4022,2688,1334
2021-04-19,HO,18,PL30,37432,39448,0,0,0
2021-10-07,SD,13,PL21,66340,66110,443,192,251
2021-10-22,RT,21,PL41,167312,162832,4624,4624,0
2021-05-04,CL,14,PL45,237344,221728,0,0,0
2021-07-17,SD,13,PL17,71262,70038,1828,560,1268
2021-08-04,CL,14,PL44,296288,292480,3072,3072,0
2021-05-02,SD,13,PL18,47000,46875,1661,1536,125
2021-03-24,CA,23,PL31,232608,231552,1272,1272,0
2021-10-12,EC,10,PL43,614544,604992,9600,9600,0
2021-11-16,HO,18,PL09,67240,67224,120,120,0
2021-09-24,DI,19,PL53,226112,225728,1792,1792,0
2021-02-07,PRG,12,PL14,392128,391296,1024,1024,0
2021-12-09,HO,18,PL10,68792,68712,96,96,0
2021-02-18,SD,13,PL20,75037,74758,890,560,330
2021-02-16,CA,23,PL02,220224,216480,4608,4608,0
2021-09-27,CA,23,PL31,163464,163008,1800,1800,0
2021-06-17,SB,11,PL36,305088,303384,2160,2160,0
2021-12-23,PRG,12,PL14,30176,30112,64,64,0
2021-02-22,SD,13,PL21,66677,66104,1181,608,573
2021-11-23,RT,21,PL06,205080,204840,312,312,0
2021-04-01,HO,18,PL33,66216,66216,0,0,0
2021-09-23,DI,19,PL53,291712,290048,2688,2688,0
2021-06-05,PR,15,PL04,264640,262624,2112,2112,0
2021-11-04,DI,19,PL52,265248,263040,3616,3616,0
2021-11-08,HO,18,PL01,67792,67600,224,224,0
2021-08-14,PB,25,PL54,445504,446176,2528,2528,0
2021-12-20,DI,19,PL53,298752,298784,384,384,0
2021-12-13,HO,18,PL01,55232,54024,1208,1208,0
2021-02-01,DI,19,PL52,296224,295712,640,640,0
2021-06-25,PW,26,PL37,805008,804336,2496,2496,0
2021-11-20,PW,26,PL37,790272,789792,2592,2592,0
2021-09-16,HO,18,PL03,62072,61768,432,432,0
2021-11-03,SD,13,PL21,64717,64649,1040,880,160
2021-09-24,RA,17,PL35,201864,199104,2760,2760,0
2021-09-23,CL,14,PL45,294752,288896,4992,4992,0
2021-06-16,EC,10,PL43,624048,623616,1152,1152,0
2021-08-15,HO,18,PL40,65616,65264,424,424,0
2021-01-10,RA,17,PL56,218832,217032,1896,1896,0
2021-03-31,CA,23,PL02,202224,198456,4416,4416,0
2021-02-07,CA,23,PL13,85136,84920,264,264,0
2021-06-12,RT,21,PL42,186336,155552,31040,31040,0
2021-07-06,HO,18,PL03,67528,67360,176,176,0
2021-07-26,CH,24,PL08,315548,312264,6932,3648,3284
2021-09-17,SD,13,PL22,68260,68177,740,656,84
2021-04-12,SD,13,PL19,62789,62477,1160,832,328
2021-06-23,PR,15,PL12,139584,139504,192,192,0
2021-09-03,PB,25,PL54,445760,444704,1408,1408,0
2021-06-07,HO,18,PL10,55984,55688,472,472,0
2021-11-07,HO,18,PL11,62664,62664,0,0,0
2021-02-18,HO,18,PL32,64512,63616,896,896,0
2021-08-03,HO,18,PL56,65960,65808,232,232,0
2021-01-20,SB,11,PL36,27864,27864,0,0,0
2021-01-09,SB,11,PL36,308712,304512,4560,4560,0
2021-05-09,SD,13,PL19,76180,76158,198,176,22
2021-01-16,RT,21,PL05,207936,208128,0,0,0
2021-12-09,SD,13,PL19,66107,64998,1315,192,1123
2021-12-15,HO,18,PL32,57136,57072,112,112,0
2021-05-04,SB,11,PL50,455808,454912,2272,2272,0
2021-11-24,RT,21,PL41,86768,79040,8512,8512,0
2021-03-24,HO,18,PL09,60872,57384,3520,3520,0
2021-06-23,SD,13,PL20,67263,67249,206,192,14
2021-10-26,SB,11,PL36,242064,239952,7272,7272,0
2021-01-07,CH,24,PL57,34148,34148,76,76,0
2021-08-17,HO,18,PL33,9232,9200,32,32,0
2021-05-15,CL,14,PL44,125152,123680,4352,4352,0
2021-09-09,RT,21,PL05,202824,203016,432,432,0
2021-09-25,CH,24,PL07,283190,278762,8792,3904,4888
2021-08-22,PRG,12,PL14,362976,355040,7936,7936,0
2021-03-31,SD,13,PL25,49242,48889,894,448,446
2021-06-20,SD,13,PL22,76312,75679,809,176,633
2021-08-02,SB,11,PL36,237360,232584,5136,5136,0
2021-09-26,PRG,12,PL14,124480,124448,32,32,0
2021-08-14,PB,25,PL55,424000,414880,10304,10304,0
2021-05-06,RT,21,PL05,207000,207264,288,288,0
2021-09-05,DI,19,PL52,283072,279936,3936,3936,0
2021-05-09,NT,16,PL51,469120,468224,1440,1440,0
2021-06-22,RA,17,PL34,221376,220464,1248,1248,0
2021-08-20,RT,21,PL05,174816,174648,1416,1416,0
2021-05-20,CA,23,PL02,231168,228144,3624,3624,0
2021-11-27,HO,18,PL11,41936,41920,112,112,0
2021-03-06,NT,16,PL51,457312,457216,800,800,0
2021-03-04,RA,17,PL56,155952,154560,1536,1536,0
2021-08-14,PRG,12,PL14,345568,329696,16160,16160,0
2021-09-07,HO,18,PL09,19920,19920,0,0,0
2021-04-14,PW,26,PL37,809760,807744,2496,2496,0
2021-08-23,CH,24,PL07,243895,237885,10874,4864,6010
2021-05-05,CH,24,PL07,279602,269529,19449,9376,10073
2021-07-22,EC,10,PL43,626304,624576,2112,2112,0
2021-08-07,CH,24,PL08,293780,287092,10606,3872,6734
2021-10-18,HO,18,PL56,66088,65968,120,120,0
2021-05-24,RT,21,PL41,0,0,0,0,0
2021-08-03,CL,14,PL44,302624,300736,1696,1696,0
2021-12-07,DI,19,PL53,219008,217440,1824,1824,0
2021-11-14,HO,18,PL01,67384,66920,464,464,0
2021-03-31,DI,19,PL53,106304,106080,640,640,0
2021-02-14,HO,18,PL32,64112,64112,1608,1608,0
2021-01-31,SD,13,PL21,71204,69247,2581,624,1957
2021-08-11,RA,17,PL34,168576,166392,2856,2856,0
2021-06-13,EC,10,PL43,510000,508320,2256,2256,0
2021-01-09,PRG,12,PL12,319296,312096,7200,7200,0
2021-10-15,SD,13,PL18,44772,44521,987,400,587
2021-06-29,DI,19,PL53,268128,266400,3104,3104,0
2021-04-26,SD,13,PL17,73136,72336,1061,192,869
2021-05-03,HO,18,PL03,64320,64168,152,152,0
2021-09-11,SD,13,PL19,74971,74890,655,544,111
2021-09-09,CH,24,PL57,34044,34000,44,44,0
2021-07-05,PB,25,PL54,430048,416416,14464,14464,0
2021-09-14,HO,18,PL33,126128,125920,208,208,0
2021-03-23,CL,14,PL44,300640,294240,1600,1600,0
2021-05-11,SB,11,PL50,374048,373184,4768,4768,0
2021-03-18,HO,18,PL32,68056,67976,88,88,0
2021-03-10,HO,18,PL10,47184,45720,1464,1464,0
2021-04-24,EC,10,PL43,0,0,6240,6240,0
2021-03-05,SD,13,PL25,66189,66025,1524,1360,164
2021-05-18,CL,14,PL45,297984,291840,4896,4896,0
2021-09-14,HO,18,PL32,48656,48632,96,96,0
2021-10-03,PR,15,PL04,264192,261600,2592,2592,0
2021-10-17,SB,11,PL36,142656,128208,14448,14448,0
2021-02-01,HO,18,PL33,68712,68712,0,0,0
2021-07-02,CA,23,PL31,233424,230616,2808,2808,0
2021-10-10,CH,24,PL57,34092,34068,44,44,0
2021-04-28,SD,13,PL22,70380,69756,3792,3168,624
2021-05-22,HO,18,PL40,62256,61672,584,584,0
2021-02-16,SD,13,PL18,71929,69777,2388,208,2180
2021-05-08,HO,18,PL32,68512,68536,0,0,0
2021-09-14,CH,24,PL12,162016,161760,560,560,0
2021-12-17,CA,23,PL35,64728,64648,168,168,0
2021-07-16,SD,13,PL19,56675,56644,2941,2832,109
2021-06-05,EC,10,PL43,626880,626208,1728,1728,0
2021-03-05,RA,17,PL56,218232,218256,288,288,0
2021-01-02,PRG,12,PL12,220992,218720,2400,2400,0
2021-09-19,CA,23,PL02,232608,232584,312,312,0
2021-05-10,EC,10,PL43,174464,174432,432,432,0
2021-05-17,CL,14,PL45,258816,251200,6944,6944,0
2021-09-21,CA,23,PL13,84776,84880,136,136,0
2021-06-11,PB,25,PL55,440256,437024,6912,6912,0
2021-09-25,SB,11,PL50,464256,463040,1888,1888,0
2021-07-03,PRG,12,PL14,387840,387264,1536,1536,0
2021-05-30,CH,24,PL07,41786,25411,18839,2464,16375
2021-01-18,EC,10,PL43,616704,613632,3264,3264,0
2021-12-01,SB,11,PL36,237264,236544,888,888,0
2021-06-12,HO,18,PL01,64584,63568,1272,1272,0
2021-12-13,RT,21,PL05,107088,106872,336,336,0
2021-06-07,HO,18,PL32,55832,55632,200,200,0
2021-10-12,CH,24,PL08,293245,287847,17526,12128,5398
2021-03-04,SB,11,PL50,445888,445088,1696,1696,0
2021-10-01,RT,21,PL05,175008,174744,528,528,0
2021-12-07,RA,17,PL34,67488,52992,14496,14496,0
2021-07-05,PW,26,PL37,815232,810672,6096,6096,0
2021-11-16,SD,13,PL20,70752,70597,523,368,155
2021-10-27,HO,18,PL01,66280,65656,968,968,0
2021-12-07,SD,13,PL25,70845,69057,1828,0,1828
2021-02-12,CH,24,PL07,7585,7476,12066,3200,8866
2021-08-28,CA,23,PL31,218280,215160,3864,3864,0
2021-06-29,CA,23,PL57,12952,12840,112,112,0
2021-07-29,PR,15,PL12,139200,139408,176,176,0
2021-10-07,NT,16,PL51,284416,283904,512,512,0
2021-03-05,EC,10,PL43,620448,619728,1056,1056,0
2021-01-17,CH,24,PL08,295257,285630,16763,7136,9627
2021-07-13,SD,13,PL18,56094,55893,2105,1904,201
2021-07-28,SD,13,PL20,75806,75707,643,544,99
2021-09-15,SB,11,PL36,305832,304368,2400,2400,0
2021-12-08,DI,19,PL52,295072,295200,416,416,0
2021-06-18,DI,19,PL53,291712,287808,4096,4096,0
2021-10-23,SB,11,PL50,458304,456928,2496,2496,0
2021-08-07,PR,15,PL24,268256,268192,64,64,0
2021-03-29,HO,18,PL33,66224,66224,0,0,0
2021-02-08,PR,15,PL24,258912,257920,1600,1600,0
2021-03-12,RT,21,PL41,0,0,7712,7712,0
2021-10-29,PW,26,PL37,279312,279072,240,240,0
2021-02-04,RA,17,PL34,218856,218784,576,576,0
2021-03-18,DI,19,PL52,233440,233696,736,736,0
2021-05-18,CA,23,PL31,212592,211536,1776,1776,0
2021-08-31,CA,23,PL13,13616,13584,104,104,0
2021-04-11,RA,17,PL35,227592,227568,24,24,0
2021-01-07,SD,13,PL18,61295,59895,1448,48,1400
2021-09-12,CH,24,PL07,263509,240837,30390,7648,22742
2021-04-22,SD,13,PL25,72366,72237,507,368,139
2021-09-08,CA,23,PL13,50344,50256,88,88,0
2021-01-10,SD,13,PL22,63973,63567,758,352,406
2021-09-07,SD,13,PL19,61311,61280,300,176,124
2021-06-24,CH,24,PL08,297903,293144,10161,5312,4849
2021-12-16,CA,23,PL31,205560,201432,4128,4128,0
2021-01-16,SD,13,PL18,71905,71760,321,176,145
2021-03-23,RT,21,PL05,183000,181104,1896,1896,0
2021-05-22,SD,13,PL17,69937,69670,946,656,290
2021-05-23,HO,18,PL03,66672,66512,160,160,0
2021-12-14,HO,18,PL01,64600,63384,1320,1320,0
2021-05-02,SD,13,PL20,53896,53713,1339,1136,203
2021-05-27,SD,13,PL17,75426,74992,991,544,447
2021-12-18,CA,23,PL13,85784,85736,96,96,0
2021-11-02,PRG,12,PL14,390368,388736,1632,1632,0
2021-12-04,SD,13,PL21,64316,63859,649,192,457
2021-09-17,SB,11,PL50,460352,460032,1696,1696,0
2021-03-02,CH,24,PL12,162736,163040,240,240,0
2021-08-12,SB,11,PL36,288528,285744,3288,3288,0
2021-03-17,RA,17,PL34,220584,220056,552,552,0
2021-06-06,CA,23,PL13,85136,85160,88,88,0
2021-08-03,RT,21,PL42,86144,72288,13936,13936,0
2021-01-20,HO,18,PL30,66072,65960,112,112,0
2021-06-21,SD,13,PL20,0,0,209,0,209
2021-06-26,EC,10,PL43,630960,628128,3024,3024,0
2021-11-24,PRG,12,PL14,389888,387712,2336,2336,0
2021-03-05,SD,13,PL19,59074,58414,2293,1632,661
2021-07-13,RT,21,PL42,180560,175168,5472,5472,0
2021-10-09,PW,26,PL37,814608,814896,912,912,0
2021-04-09,HO,18,PL30,55408,55184,224,224,0
2021-07-03,HO,18,PL09,72368,72344,88,88,0
2021-07-25,EC,10,PL43,275328,274272,3600,3600,0
2021-05-25,HO,18,PL01,67168,66776,416,416,0
2021-10-11,CL,14,PL45,260480,253280,6656,6656,0
2021-11-14,CH,24,PL07,231468,229204,5112,2848,2264
2021-07-09,RT,21,PL41,0,1232,0,0,0
2021-06-25,RT,21,PL06,205704,205488,432,432,0
2021-12-06,RT,21,PL05,193704,187608,6216,6216,0
2021-10-01,HO,18,PL11,66296,66192,104,104,0
2021-01-31,NT,16,PL51,462752,462880,384,384,0
2021-03-31,HO,18,PL03,65856,65840,104,104,0
2021-01-24,RA,17,PL34,220128,220008,288,288,0
2021-01-27,SD,13,PL17,65017,64810,2415,2208,207
2021-05-22,EC,10,PL43,617520,616128,1200,1200,0
2021-07-29,CH,24,PL08,254626,248930,11166,5376,5790
2021-03-19,HO,18,PL33,24624,24416,232,232,0
2021-05-15,SD,13,PL22,61678,61205,3866,3328,538
2021-12-14,CA,23,PL02,137616,137208,2136,2136,0
2021-09-02,HO,18,PL33,2656,2656,0,0,0
2021-11-26,DI,19,PL52,118592,118400,2144,2144,0
2021-12-01,SD,13,PL22,46179,46113,359,272,87
2021-05-17,RT,21,PL42,29760,28336,1424,1424,0
2021-10-24,NT,16,PL51,509088,508768,736,736,0
2021-05-18,PW,26,PL37,790944,785424,7104,7104,0
2021-09-04,SB,11,PL36,246480,245016,1920,1920,0
2021-05-03,CH,24,PL07,307177,289741,28508,11072,17436
2021-05-25,RA,17,PL35,104280,103920,4824,4824,0
2021-07-16,HO,18,PL09,73176,73176,0,0,0
2021-01-29,PRG,12,PL12,389472,388736,736,736,0
2021-12-09,NT,16,PL51,473600,468352,6048,6048,0
2021-03-25,CL,14,PL45,260512,251520,4640,4640,0
2021-02-24,SD,13,PL19,470,435,760,688,72
2021-08-03,HO,18,PL30,66216,66216,0,0,0
2021-05-09,EC,10,PL43,179632,179168,368,368,0
2021-12-10,SD,13,PL20,76184,75624,810,208,602
2021-01-09,PR,15,PL04,234368,228800,5568,5568,0
2021-09-12,SD,13,PL17,60259,60100,1887,1728,159
2021-05-17,PR,15,PL04,31872,26272,5600,5600,0
2021-07-22,HO,18,PL56,65992,65632,360,360,0
2021-11-20,NT,16,PL51,494624,474976,24352,24352,0
2021-01-30,RT,21,PL06,205320,205152,744,744,0
2021-10-29,HO,18,PL11,21008,20896,112,112,0
2021-12-01,HO,18,PL10,69280,69336,0,0,0
2021-04-27,HO,18,PL32,47816,47288,528,528,0
2021-01-12,PRG,12,PL14,390752,390496,832,832,0
2021-08-18,CA,23,PL02,0,0,1416,1416,0
2021-09-05,PR,15,PL24,264480,264320,992,992,0
2021-10-16,PW,26,PL37,717504,715392,2640,2640,0
2021-01-13,CA,23,PL02,208656,207216,1800,1800,0
2021-10-10,SD,13,PL21,64780,64558,434,176,258
2021-08-29,CA,23,PL02,158880,157584,1512,1512,0
2021-11-20,PRG,12,PL12,29664,20096,13120,13120,0
2021-08-02,PR,15,PL24,248736,248320,416,416,0
2021-04-12,DI,19,PL53,295072,294176,1248,1248,0
2021-09-18,SD,13,PL21,61402,61046,549,192,357
2021-07-27,SD,13,PL25,72182,71525,1233,576,657
2021-09-29,HO,18,PL40,66192,66224,0,0,0
2021-04-20,SD,13,PL18,74103,74069,275,192,83
2021-09-29,HO,18,PL11,65144,64928,320,320,0
2021-06-28,RA,17,PL35,179640,179064,3552,3552,0
2021-05-25,HO,18,PL10,54688,54656,136,136,0
2021-05-07,HO,18,PL33,66216,66216,0,0,0
2021-07-08,HO,18,PL09,72384,72296,88,88,0
2021-04-09,HO,18,PL01,65416,65320,104,104,0
2021-11-12,RA,17,PL34,21264,20376,888,888,0
2021-03-21,CH,24,PL08,292081,271687,29002,8608,20394
2021-11-17,RT,21,PL05,106824,106080,3408,3408,0
2021-11-17,SD,13,PL17,42707,42514,2641,2448,193
2021-07-24,CH,24,PL07,0,0,0,0,0
2021-10-19,PRG,12,PL14,385024,384832,3648,3648,0
2021-05-26,PB,25,PL55,284480,283552,2336,2336,0
2021-09-12,CH,24,PL57,33020,32968,52,52,0
2021-10-11,RT,21,PL06,197016,192456,4560,4560,0
2021-09-08,SD,13,PL18,75048,74818,887,560,327
2021-10-25,RT,21,PL06,164808,158808,6216,6216,0
2021-03-22,RA,17,PL56,217944,212928,5112,5112,0
2021-03-13,SD,13,PL21,73311,72796,1155,640,515
2021-08-21,HO,18,PL09,72544,72448,96,96,0
2021-12-19,HO,18,PL32,56832,56784,152,152,0
2021-05-02,RA,17,PL34,221040,220608,432,432,0
2021-05-09,DI,19,PL52,290624,287424,3200,3200,0
2021-07-29,HO,18,PL11,0,0,0,0,0
2021-10-29,HO,18,PL56,21200,21096,104,104,0
2021-10-25,RA,17,PL35,263184,262344,984,984,0
2021-05-15,CA,23,PL11,210792,207000,3936,3936,0
2021-12-12,SB,11,PL50,368448,368576,704,704,0
2021-03-03,RT,21,PL05,209568,209784,0,0,0
2021-11-17,CA,23,PL02,232056,231864,600,600,0
2021-11-19,HO,18,PL30,0,0,2656,2656,0
2021-04-14,PB,25,PL54,404032,250752,154752,154752,0
2021-09-25,SD,13,PL22,75164,75140,435,368,67
2021-01-02,DI,19,PL53,98336,97120,1600,1600,0
2021-02-08,HO,18,PL09,50504,49800,1552,1552,0
2021-06-19,NT,16,PL51,463264,459936,3840,3840,0
2021-02-21,SD,13,PL20,76408,76163,496,192,304
2021-04-13,HO,18,PL03,66144,66184,0,0,0
2021-09-04,SD,13,PL18,76581,76268,489,176,313
2021-07-25,CA,23,PL31,222432,221496,1296,1296,0
2021-10-09,SB,11,PL50,464704,463648,1696,1696,0
2021-05-31,PB,25,PL55,433888,425376,12352,12352,0
2021-10-21,EC,10,PL43,548736,531888,16800,16800,0
2021-05-27,EC,10,PL43,537744,527424,11328,11328,0
2021-10-18,CL,14,PL45,0,0,6016,6016,0
2021-02-21,RA,17,PL35,190296,187824,3000,3000,0
2021-03-13,RT,21,PL06,209808,208728,1032,1032,0
2021-10-07,PW,26,PL37,803328,797136,6528,6528,0
2021-11-21,NT,16,PL51,509536,509152,1056,1056,0
2021-01-20,SD,13,PL25,69467,69259,816,608,208
2021-03-11,SD,13,PL21,72342,71843,995,496,499
2021-03-27,SD,13,PL21,46867,46558,5008,4688,320
2021-05-18,CH,24,PL08,170693,166875,12030,7456,4574
2021-06-11,SD,13,PL25,72887,71993,1292,384,908
2021-06-20,CA,23,PL11,235224,234864,576,576,0
2021-08-15,RA,17,PL34,219552,219576,720,720,0
2021-11-09,SD,13,PL20,56141,55917,1020,752,268
2021-12-18,SD,13,PL25,73798,73293,681,176,505
2021-01-15,PR,15,PL04,266368,266432,224,224,0
2021-10-28,CL,14,PL44,303360,299520,3200,3200,0
2021-08-06,CA,23,PL31,182232,181776,1104,1104,0
2021-06-16,HO,18,PL03,0,0,0,0,0
2021-04-05,CA,23,PL02,230448,228672,2400,2400,0
2021-08-27,HO,18,PL03,66856,66632,224,224,0
2021-10-01,CH,24,PL08,302382,299600,8574,5792,2782
2021-03-02,DI,19,PL52,251904,251808,2336,2336,0
2021-05-10,CA,23,PL31,235104,233208,2040,2040,0
2021-11-16,SD,13,PL21,26653,26031,5598,4976,622
2021-01-19,HO,18,PL09,71048,71016,128,128,0
2021-07-14,PRG,12,PL14,197600,189184,8896,8896,0
2021-09-12,SD,13,PL20,74363,74315,224,176,48
2021-11-22,CA,23,PL31,227880,224640,3936,3936,0
2021-12-10,CH,24,PL07,196005,163496,37042,4352,32690
2021-10-23,PB,25,PL54,389856,378976,17536,17536,0
2021-10-02,PRG,12,PL14,389216,389120,1472,1472,0
2021-02-25,SD,13,PL17,74408,74307,299,176,123
2021-05-07,SD,13,PL25,72713,71792,1135,176,959
2021-10-03,SD,13,PL21,62978,62630,1116,768,348
2021-07-21,HO,18,PL32,65816,65528,288,288,0
2021-11-10,SD,13,PL22,59812,59536,2033,1616,417
2021-11-11,PRG,12,PL14,388992,388960,1312,1312,0
2021-05-17,HO,18,PL10,48120,47984,1672,1672,0
2021-09-22,PR,15,PL04,262976,261568,1856,1856,0
2021-05-18,CA,23,PL13,81032,80856,248,248,0
2021-10-25,RA,17,PL34,75936,75480,456,456,0
2021-01-21,HO,18,PL32,68616,68384,232,232,0
2021-02-03,CL,14,PL45,183968,177792,2336,2336,0
2021-03-28,EC,10,PL43,197904,133200,52416,52416,0
2021-03-25,SD,13,PL22,73743,73542,377,176,201
2021-09-10,RT,21,PL42,183200,180688,3744,3744,0
2021-03-04,HO,18,PL10,53552,53304,312,312,0
2021-01-21,CH,24,PL08,259082,248818,16689,6240,10449
2021-11-14,SD,13,PL19,70607,70539,1184,1040,144
2021-07-10,CL,14,PL44,299840,298368,1088,1088,0
2021-11-30,HO,18,PL01,61416,60448,1056,1056,0
2021-10-28,PW,26,PL37,817968,817872,1440,1440,0
2021-09-09,SD,13,PL17,57356,57127,1451,1200,251
2021-09-19,CH,24,PL12,164928,164720,192,192,0
2021-09-18,PR,15,PL04,20992,0,22624,22624,0
2021-11-17,RT,21,PL06,208824,208800,288,288,0
2021-08-08,CL,14,PL45,182240,180128,1664,1664,0
2021-09-27,PR,15,PL04,263904,261472,2944,2944,0
2021-10-12,HO,18,PL11,60128,59848,752,752,0
2021-01-27,HO,18,PL30,66160,66160,0,0,0
2021-02-18,PRG,12,PL12,389504,387744,1760,1760,0
2021-01-12,PR,15,PL04,263968,263456,512,512,0
2021-05-26,HO,18,PL33,0,0,0,0,0
2021-10-23,SD,13,PL19,75072,74872,592,352,240
2021-03-25,SD,13,PL18,21215,17703,9512,6000,3512
2021-06-27,PR,15,PL04,264736,263776,960,960,0
2021-01-10,DI,19,PL53,274208,274496,0,0,0
2021-10-27,PW,26,PL37,718080,716832,1872,1872,0
2021-07-10,PW,26,PL37,818928,804144,16128,16128,0
2021-07-03,PB,25,PL55,441440,441600,1120,1120,0
2021-10-10,HO,18,PL33,125728,125792,368,368,0
2021-06-08,RA,17,PL35,0,0,4920,4920,0
2021-03-21,NT,16,PL57,154928,154752,176,176,0
2021-05-20,HO,18,PL01,66248,64592,1656,1656,0
2021-09-21,RT,21,PL42,193776,193616,240,240,0
2021-12-15,CA,23,PL02,216216,214368,1944,1944,0
2021-04-24,PR,15,PL04,264704,264288,416,416,0
2021-05-24,SB,11,PL50,0,0,0,0,0
2021-10-22,CH,24,PL12,164928,164624,368,368,0
2021-05-22,SD,13,PL22,64823,64271,1432,880,552
2021-09-22,CA,23,PL13,84992,84560,560,560,0
2021-09-23,HO,18,PL40,65480,65456,96,96,0
2021-09-28,RA,17,PL35,160272,153432,8448,8448,0
2021-06-21,RA,17,PL34,224448,224448,0,0,0
2021-10-03,HO,18,PL40,65272,65056,216,216,0
2021-11-30,HO,18,PL10,68408,68328,104,104,0
2021-11-26,RA,17,PL34,219648,217440,2208,2208,0
2021-05-31,HO,18,PL09,71640,71600,88,88,0
2021-07-10,EC,10,PL43,629808,629328,576,576,0
2021-11-05,PRG,12,PL12,386720,385312,2336,2336,0
2021-11-01,SD,13,PL18,75532,75093,1105,640,465
2021-03-03,HO,18,PL03,63896,63680,464,464,0
2021-11-13,SD,13,PL22,62736,62634,3558,3456,102
2021-03-12,NT,16,PL51,469120,467936,1888,1888,0
2021-09-12,HO,18,PL40,66280,65648,632,632,0
2021-10-01,PRG,12,PL14,271360,269344,3296,3296,0
2021-08-02,SD,13,PL18,57296,56345,3735,2784,951
2021-08-06,HO,18,PL10,68424,68200,224,224,0
2021-09-17,HO,18,PL09,55552,55280,272,272,0
2021-03-31,CA,23,PL13,41776,41736,88,88,0
2021-09-08,PB,25,PL54,443616,442848,2400,2400,0
2021-02-20,CL,14,PL45,305056,281344,608,608,0
2021-06-13,HO,18,PL01,66896,65936,1000,1000,0
2021-01-06,HO,18,PL11,65600,65496,104,104,0
2021-09-01,CA,23,PL13,74520,74176,408,408,0
2021-12-04,HO,18,PL40,65480,65488,104,104,0
2021-01-23,RT,21,PL05,194832,190704,4416,4416,0
2021-09-20,RT,21,PL42,188576,186464,2400,2400,0
2021-06-09,HO,18,PL32,19952,19936,16,16,0
2021-01-08,CA,23,PL13,48888,48600,304,304,0
2021-03-25,RT,21,PL41,0,0,24016,24016,0
2021-07-25,HO,18,PL01,67056,65984,1072,1072,0
2021-08-23,PRG,12,PL14,391712,391456,1536,1536,0
2021-09-11,CH,24,PL07,247739,233994,20081,6336,13745
2021-01-13,PRG,12,PL14,390752,391008,928,928,0
2021-06-19,PR,15,PL04,264480,259744,4928,4928,0
2021-09-21,RT,21,PL41,170544,165376,6688,6688,0
2021-10-30,SB,11,PL50,371616,352800,18816,18816,0
2021-11-10,RT,21,PL06,206832,206520,576,576,0
2021-07-22,SD,13,PL20,76065,76044,439,352,87
2021-12-14,RT,21,PL06,148320,148056,1176,1176,0
2021-02-23,SD,13,PL17,73309,73301,263,176,87
2021-07-06,PR,15,PL12,138992,139056,176,176,0
2021-10-14,PW,26,PL37,797088,790032,7488,7488,0
2021-11-14,HO,18,PL56,59432,59208,224,224,0
2021-03-21,HO,18,PL11,66288,66288,0,0,0
2021-02-03,DI,19,PL53,166656,162016,5728,5728,0
2021-10-18,NT,16,PL51,509312,509216,416,416,0
2021-11-08,CL,14,PL45,254976,248992,8224,8224,0
2021-05-09,HO,18,PL09,72496,72408,88,88,0
2021-04-07,HO,18,PL30,66144,66160,0,0,0
2021-07-28,SD,13,PL25,55888,55081,999,192,807
2021-07-24,HO,18,PL30,3368,3368,816,816,0
2021-01-20,HO,18,PL09,72416,72328,88,88,0
2021-07-06,SD,13,PL17,69556,67960,6220,4624,1596
2021-02-27,HO,18,PL01,52824,51928,896,896,0
2021-02-26,NT,16,PL51,467328,465376,1952,1952,0
2021-05-02,PB,25,PL55,448992,448192,1408,1408,0
2021-03-16,HO,18,PL01,66000,65792,232,232,0
2021-03-19,DI,19,PL52,295040,290912,4480,4480,0
2021-11-29,DI,19,PL53,290720,290176,832,832,0
2021-10-10,CH,24,PL07,298112,294777,9537,5280,4257
2021-05-04,CH,24,PL07,184169,177501,27559,20704,6855
2021-06-09,PRG,12,PL14,386048,384992,1408,1408,0
2021-10-04,SD,13,PL21,66243,65972,271,0,271
2021-09-21,CA,23,PL31,158256,158208,576,576,0
2021-07-10,HO,18,PL30,66176,65808,352,352,0
2021-11-10,PRG,12,PL14,392896,393120,864,864,0
2021-02-25,CA,23,PL02,167568,167640,1512,1512,0
2021-08-16,SD,13,PL18,53522,52875,3345,2640,705
2021-03-28,DI,19,PL53,294944,294880,384,384,0
2021-03-14,CL,14,PL45,290336,266080,4256,4256,0
2021-03-31,PR,15,PL57,16528,16272,31152,31152,0
2021-05-17,RT,21,PL06,160776,158640,2496,2496,0
2021-06-10,SB,11,PL36,38472,38136,336,336,0
2021-03-27,HO,18,PL32,51504,49800,1776,1776,0
2021-03-31,PW,26,PL37,385200,382848,2928,2928,0
2021-10-06,RA,17,PL34,175704,172200,4272,4272,0
2021-02-05,HO,18,PL11,66288,66288,0,0,0
2021-01-09,HO,18,PL03,66328,66208,120,120,0
2021-01-03,HO,18,PL30,66160,66160,0,0,0
2021-03-03,CA,23,PL02,236112,235296,912,912,0
2021-04-27,CA,23,PL13,84560,84480,1040,1040,0
2021-06-26,CL,14,PL44,257504,253376,3648,3648,0
2021-07-27,HO,18,PL01,60200,59928,272,272,0
2021-06-12,RA,17,PL35,227184,227376,0,0,0
2021-03-03,SD,13,PL22,33083,32969,3914,3792,122
2021-10-14,DI,19,PL52,240512,235104,5600,5600,0
2021-10-29,HO,18,PL03,20216,20216,0,0,0
2021-03-05,PR,15,PL24,171104,140576,30624,30624,0
2021-09-19,HO,18,PL56,65784,64904,928,928,0
2021-07-13,PRG,12,PL14,381504,376672,4832,4832,0
2021-07-04,RA,17,PL35,141336,135216,6120,6120,0
2021-09-28,HO,18,PL56,65896,65336,592,592,0
2021-02-19,NT,16,PL51,467040,464192,2848,2848,0
2021-03-21,PW,26,PL37,814224,811488,2736,2736,0
2021-11-30,SD,13,PL19,65122,65015,299,192,107
2021-04-15,SD,13,PL25,70847,70715,707,560,147
2021-04-22,CA,23,PL11,227424,222984,5520,5520,0
2021-11-20,HO,18,PL01,66072,64904,1208,1208,0
2021-02-05,HO,18,PL10,57616,57672,8,8,0
2021-04-16,CH,24,PL12,124320,123488,1152,1152,0
2021-07-31,SD,13,PL25,636,1815,32,16,16
2021-10-04,PW,26,PL37,807936,806832,8208,8208,0
2021-03-29,HO,18,PL01,63176,62808,368,368,0
2021-05-05,SD,13,PL25,28246,27445,1825,1024,801
2021-04-28,RT,21,PL06,191616,190800,816,816,0
2021-11-13,NT,16,PL51,507520,507904,768,768,0
2021-09-25,DI,19,PL53,295072,294880,352,352,0
2021-10-10,SD,13,PL18,68993,68106,1155,256,899
2021-11-01,RT,21,PL05,139872,134400,5664,5664,0
2021-04-05,HO,18,PL30,66224,66224,0,0,0
2021-10-27,CH,24,PL24,163760,163712,448,448,0
2021-05-08,SD,13,PL20,73684,73538,768,560,208
2021-05-29,SD,13,PL25,72802,72333,837,368,469
2021-04-23,CA,23,PL11,200496,198864,3504,3504,0
2021-01-14,CA,23,PL13,83368,80496,2960,2960,0
2021-12-05,CA,23,PL13,76328,76288,328,328,0
2021-10-03,HO,18,PL32,54608,54360,248,248,0
2021-04-26,DI,19,PL52,261984,258816,3808,3808,0
2021-06-26,SD,13,PL20,63450,61990,1765,208,1557
2021-11-11,SD,13,PL19,74356,74153,380,176,204
2021-07-15,HO,18,PL03,65904,65640,344,344,0
2021-12-08,SD,13,PL19,62882,61859,1291,240,1051
2021-02-20,PB,25,PL55,446304,445600,1216,1216,0
2021-02-25,CH,24,PL08,273894,269012,11220,6240,4980
2021-06-04,CH,24,PL08,232246,224222,14520,6496,8024
2021-09-24,RT,21,PL05,205344,204936,696,696,0
2021-02-13,CH,24,PL07,59224,55894,11777,3872,7905
2021-04-22,HO,18,PL30,66208,66224,0,0,0
2021-12-05,SD,13,PL21,56184,55815,771,384,387
2021-02-03,CH,24,PL08,158408,140179,32428,7424,25004
2021-02-18,SD,13,PL22,71959,71862,705,544,161
2021-05-12,SB,11,PL36,247152,245952,1200,1200,0
2021-07-27,HO,18,PL10,62584,61864,840,840,0
2021-03-20,HO,18,PL03,59104,58992,112,112,0
2021-11-26,SD,13,PL20,76674,76593,133,0,133
2021-06-03,CA,23,PL02,231624,231336,648,648,0
2021-06-20,SD,13,PL19,53324,52953,1251,880,371
2021-10-05,EC,10,PL43,560784,558720,2736,2736,0
2021-08-14,CL,14,PL45,286624,279904,3584,3584,0
2021-02-13,PRG,12,PL12,388320,387584,1952,1952,0
2021-04-21,CH,24,PL08,302306,291969,16093,5408,10685
2021-01-03,SD,13,PL19,72374,72374,176,176,0
2021-02-14,SD,13,PL22,72395,72246,341,192,149
2021-04-10,RA,17,PL34,211104,208152,3048,3048,0
2021-11-03,PRG,12,PL14,390560,389824,1856,1856,0
2021-06-16,NT,16,PL51,414816,408160,6752,6752,0
2021-07-26,CL,14,PL44,157344,156192,1408,1408,0
2021-01-24,CA,23,PL13,85328,85368,96,96,0
2021-07-30,HO,18,PL40,65368,64992,376,376,0
2021-10-01,CL,14,PL44,246336,233792,12128,12128,0
2021-04-01,RT,21,PL42,179776,173728,6336,6336,0
2021-01-31,RA,17,PL34,218496,217392,1632,1632,0
2021-04-27,SD,13,PL17,65477,65181,1092,784,308
2021-03-22,PB,25,PL55,446208,444544,2336,2336,0
2021-03-18,RT,21,PL41,0,0,34192,34192,0
2021-07-06,PR,15,PL24,264544,264480,384,384,0
2021-01-26,RT,21,PL06,183384,182904,3960,3960,0
2021-05-11,HO,18,PL09,72512,72448,128,128,0
2021-07-16,RT,21,PL05,203592,203856,600,600,0
2021-06-25,HO,18,PL09,72360,72248,104,104,0
2021-06-26,RT,21,PL05,206040,205272,768,768,0
2021-10-02,CL,14,PL44,26720,22976,3776,3776,0
2021-01-07,PR,15,PL24,265504,264192,1472,1472,0
2021-04-15,PB,25,PL54,448192,435936,13280,13280,0
2021-11-04,HO,18,PL32,56808,56536,368,368,0
2021-06-27,PB,25,PL54,426688,414304,12832,12832,0
2021-11-02,RT,21,PL42,126576,124320,3936,3936,0
2021-07-04,DI,19,PL52,205504,198528,7392,7392,0
2021-04-21,SD,13,PL19,74996,74942,790,736,54
2021-07-07,RT,21,PL06,139632,139440,408,408,0
2021-05-02,RA,17,PL56,219840,219552,576,576,0
2021-11-14,RA,17,PL35,115080,114696,384,384,0
2021-04-28,CA,23,PL02,196200,195912,1128,1128,0
2021-06-24,PR,15,PL04,262016,258528,4000,4000,0
2021-02-01,RT,21,PL06,204360,204216,624,624,0
2021-12-22,CH,24,PL12,153664,153536,192,192,0
2021-09-03,RA,17,PL34,221040,218208,2808,2808,0
2021-07-22,PB,25,PL55,444416,442944,4032,4032,0
2021-07-16,RT,21,PL42,192848,189152,3840,3840,0
2021-01-27,DI,19,PL53,265312,263296,2208,2208,0
2021-08-12,HO,18,PL56,66144,66008,136,136,0
2021-03-06,RT,21,PL42,178480,172128,6864,6864,0
2021-04-09,SD,13,PL21,73571,73347,592,368,224
2021-05-06,SD,13,PL22,75055,74807,750,432,318
2021-12-09,DI,19,PL53,294880,287904,7296,7296,0
2021-03-04,DI,19,PL53,294848,293856,1600,1600,0
2021-10-26,HO,18,PL33,82976,79440,3536,3536,0
2021-11-24,HO,18,PL30,0,0,688,688,0
2021-01-15,CH,24,PL57,33896,33872,44,44,0
2021-02-11,EC,10,PL43,624432,624048,1296,1296,0
2021-02-27,EC,10,PL43,620880,618576,2208,2208,0
2021-09-30,RA,17,PL34,201336,197472,4104,4104,0
2021-09-26,CH,24,PL57,34264,34216,48,48,0
2021-12-18,PRG,12,PL14,393984,393024,960,960,0
2021-04-08,CH,24,PL12,164384,164560,192,192,0
2021-06-26,PR,15,PL04,265568,265248,736,736,0
2021-09-15,CA,23,PL31,206616,203232,4056,4056,0
2021-07-08,HO,18,PL01,0,0,184,184,0
2021-01-04,DI,19,PL53,270816,264256,6656,6656,0
2021-09-08,HO,18,PL56,65456,65352,104,104,0
2021-05-30,SD,13,PL17,75726,75077,1033,384,649
2021-12-09,SB,11,PL50,369824,368128,9664,9664,0
2021-07-02,CL,14,PL44,111008,109312,2240,2240,0
2021-10-30,CH,24,PL24,0,0,2896,2896,0
2021-03-02,EC,10,PL43,482592,481968,1104,1104,0
2021-02-05,PRG,12,PL12,292096,241120,50976,50976,0
2021-10-01,CL,14,PL45,291136,286016,4544,4544,0
2021-09-20,DI,19,PL53,295136,295232,448,448,0
2021-01-31,RT,21,PL42,161568,154736,6832,6832,0
2021-10-01,HO,18,PL09,67712,67648,88,88,0
2021-12-17,DI,19,PL53,251616,248576,6560,6560,0
2021-01-17,DI,19,PL53,299232,299648,0,0,0
2021-02-12,RT,21,PL42,135888,113808,22160,22160,0
2021-06-23,SB,11,PL36,310872,308256,2832,2832,0
2021-03-08,RT,21,PL06,206928,205992,936,936,0
2021-03-30,PR,15,PL24,252256,251072,1728,1728,0
2021-01-10,CA,23,PL31,30096,30096,0,0,0
2021-02-13,HO,18,PL32,68648,68648,0,0,0
2021-06-14,SD,13,PL19,70447,70052,571,176,395
2021-12-15,RT,21,PL06,206928,206952,264,264,0
2021-05-04,SD,13,PL20,72516,72345,1089,928,161
2021-04-09,RA,17,PL56,157608,147840,9768,9768,0
2021-05-12,CH,24,PL08,281983,267601,27606,13216,14390
2021-02-12,SD,13,PL17,33956,33279,4755,4064,691
2021-06-27,RA,17,PL35,226056,224736,1464,1464,0
2021-12-01,SD,13,PL19,58668,58333,776,368,408
2021-04-27,PB,25,PL54,147712,123040,25344,25344,0
2021-07-28,SD,13,PL19,63472,63438,402,368,34
2021-09-24,SD,13,PL19,74603,74424,547,368,179
2021-05-15,SD,13,PL21,21951,21291,5781,5088,693
2021-02-24,SD,13,PL18,73742,72624,1310,192,1118
2021-04-23,RT,21,PL42,104448,103296,1152,1152,0
2021-11-09,CL,14,PL45,289632,282976,5216,5216,0
2021-09-25,CL,14,PL45,276960,269696,6080,6080,0
2021-01-02,PR,15,PL24,125408,123744,1952,1952,0
2021-04-10,PRG,12,PL14,391680,391456,928,928,0
2021-07-28,CL,14,PL44,89216,73216,15904,15904,0
2021-07-10,SD,13,PL25,74534,74089,784,352,432
2021-07-24,HO,18,PL32,3592,3592,400,400,0
2021-12-08,PR,15,PL04,264096,263680,576,576,0
2021-10-21,DI,19,PL52,229312,227520,8608,8608,0
2021-10-01,CH,24,PL12,164864,164768,256,256,0
2021-04-14,RT,21,PL06,201936,198360,3744,3744,0
2021-10-21,CA,23,PL13,81472,81368,200,200,0
2021-09-18,CA,23,PL13,85112,85096,112,112,0
2021-01-03,PRG,12,PL14,391872,390656,2208,2208,0
2021-04-29,HO,18,PL32,67552,67312,240,240,0
2021-01-16,SD,13,PL20,73794,73668,702,576,126
2021-03-07,PW,26,PL37,807072,805008,2544,2544,0
2021-09-08,PR,15,PL24,264992,264128,1120,1120,0
2021-11-09,DI,19,PL52,292736,292992,960,960,0
2021-03-01,CA,23,PL02,233328,231432,1992,1992,0
2021-12-20,NT,16,PL57,224768,223296,3904,3904,0
2021-11-11,SD,13,PL17,66810,66613,753,528,225
2021-11-05,SD,13,PL21,56294,56088,222,16,206
2021-01-08,SD,13,PL25,68358,68004,722,368,354
2021-06-17,PB,25,PL54,127328,126400,4384,4384,0
2021-01-06,CA,23,PL13,84064,81576,2592,2592,0
2021-05-25,HO,18,PL32,65336,65240,248,248,0
2021-03-28,NT,16,PL57,154096,153872,464,464,0
2021-05-05,PW,26,PL37,524976,525840,2448,2448,0
2021-01-12,HO,18,PL09,65296,65160,136,136,0
2021-04-26,SD,13,PL25,1,1,0,0,0
2021-05-28,SD,13,PL19,76324,76372,202,176,26
2021-07-21,HO,18,PL03,64024,63904,120,120,0
2021-06-05,DI,19,PL53,290016,288992,2080,2080,0
2021-11-19,HO,18,PL01,66672,65280,1376,1376,0
2021-10-19,RT,21,PL41,86000,84672,2704,2704,0
2021-05-11,SD,13,PL18,74298,74067,600,368,232
2021-02-13,RA,17,PL35,223176,223080,264,264,0
2021-01-15,SD,13,PL18,35654,35518,4778,4656,122
2021-07-18,CA,23,PL31,179088,178344,1080,1080,0
2021-11-26,HO,18,PL01,66768,65672,1096,1096,0
2021-06-13,PR,15,PL12,139488,139392,192,192,0
2021-11-12,PR,15,PL04,262688,262368,640,640,0
2021-06-15,HO,18,PL40,66336,66336,0,0,0
2021-07-25,PB,25,PL55,211200,203968,40032,40032,0
2021-04-10,SD,13,PL25,73385,73090,471,176,295
2021-09-10,RA,17,PL34,133056,127584,5472,5472,0
2021-07-05,CH,24,PL57,32636,32560,192,192,0
2021-01-06,HO,18,PL01,66040,65376,712,712,0
2021-07-21,SD,13,PL19,64838,64806,288,256,32
2021-04-12,SB,11,PL50,452032,450848,2208,2208,0
2021-09-09,HO,18,PL11,65032,64944,120,120,0
2021-11-14,SD,13,PL17,68036,67870,550,384,166
2021-03-07,RA,17,PL56,219072,218760,696,696,0
2021-08-13,SD,13,PL25,76033,75665,462,0,462
2021-11-08,RT,21,PL05,154248,148224,6408,6408,0
2021-10-27,CH,24,PL57,34144,34116,60,60,0
2021-03-17,PR,15,PL24,263104,263072,928,928,0
2021-06-15,HO,18,PL10,53464,53272,192,192,0
2021-02-07,HO,18,PL01,65440,64968,536,536,0
2021-05-05,PRG,12,PL14,386432,380704,7200,7200,0
2021-02-01,EC,10,PL43,596352,594288,1728,1728,0
2021-06-01,SB,11,PL36,305088,300192,5016,5016,0
2021-01-02,CH,24,PL08,59604,59221,4920,4096,824
2021-06-02,HO,18,PL03,66616,66592,208,208,0
2021-07-04,HO,18,PL32,68584,68584,0,0,0
2021-08-12,PR,15,PL24,267904,267808,448,448,0
2021-04-20,CA,23,PL31,137424,135984,1440,1440,0
2021-08-11,EC,10,PL43,630912,629184,1824,1824,0
2021-01-17,RT,21,PL05,200712,198048,2976,2976,0
2021-01-12,CA,23,PL31,215424,208488,7296,7296,0
2021-04-30,RA,17,PL56,217800,217224,576,576,0
2021-07-13,PB,25,PL54,379552,358304,21248,21248,0
2021-04-15,SD,13,PL22,73679,73549,307,176,131
2021-01-19,CH,24,PL57,33252,33184,160,160,0
2021-11-18,EC,10,PL43,630528,630720,672,672,0
2021-12-18,CH,24,PL12,163808,163840,400,400,0
2021-03-18,HO,18,PL10,48432,48040,392,392,0
2021-03-21,SD,13,PL19,68126,66673,5853,4400,1453
2021-01-10,CA,23,PL13,84480,82912,1656,1656,0
2021-05-07,RT,21,PL06,205224,204744,720,720,0
2021-05-30,CA,23,PL13,85456,85368,88,88,0
2021-01-29,PR,15,PL24,263104,253856,9984,9984,0
2021-03-19,PW,26,PL37,715488,715056,5616,5616,0
2021-05-28,RT,21,PL42,166816,151616,16800,16800,0
2021-06-10,PR,15,PL12,122656,120544,2192,2192,0
2021-03-31,PB,25,PL54,441632,436544,5632,5632,0
2021-01-15,SB,11,PL36,314280,313128,1632,1632,0
2021-06-05,SD,13,PL21,66331,65850,1767,1216,551
2021-01-14,PRG,12,PL12,393760,393376,928,928,0
2021-03-11,RA,17,PL35,219504,213504,6144,6144,0
2021-06-18,CA,23,PL11,230520,229704,1152,1152,0
2021-07-18,HO,18,PL33,63688,63720,192,192,0
2021-10-22,SD,13,PL21,57432,57144,3552,3264,288
2021-05-11,RT,21,PL06,24888,23976,912,912,0
2021-02-27,HO,18,PL03,51856,51280,576,576,0
2021-05-25,HO,18,PL33,0,0,288,288,0
2021-02-12,PR,15,PL57,141872,141968,192,192,0
2021-04-06,CA,23,PL02,115320,109272,6576,6576,0
2021-05-17,DI,19,PL53,292864,292576,1184,1184,0
2021-09-28,NT,16,PL51,509888,509504,1440,1440,0
2021-01-21,NT,16,PL51,0,0,1472,1472,0
2021-10-27,CH,24,PL12,162960,162816,384,384,0
2021-01-03,HO,18,PL09,66288,66288,0,0,0
2021-12-17,CH,24,PL12,162592,161984,608,608,0
2021-10-04,SB,11,PL36,99720,92808,13368,13368,0
2021-07-26,HO,18,PL03,65224,64464,872,872,0
2021-03-17,SD,13,PL25,73329,73284,487,416,71
2021-07-31,SD,13,PL22,53022,52992,442,368,74
2021-02-20,DI,19,PL53,295168,294688,672,672,0
2021-06-27,PW,26,PL37,816240,813744,2976,2976,0
2021-10-15,RA,17,PL34,207792,205248,3096,3096,0
2021-02-18,CL,14,PL44,294912,265408,12672,12672,0
2021-08-26,SD,13,PL20,66400,66253,1252,1104,148
2021-10-18,CA,23,PL31,233520,230208,3432,3432,0
2021-02-12,HO,18,PL01,65304,64864,440,440,0
2021-09-10,PRG,12,PL14,390368,386080,5504,5504,0
2021-03-27,DI,19,PL52,266816,263648,3456,3456,0
2021-02-05,NT,16,PL51,462176,460000,2464,2464,0
2021-01-02,SD,13,PL25,47814,47356,458,0,458
2021-08-26,PR,15,PL04,352096,351200,1504,1504,0
2021-09-06,PR,15,PL04,5952,0,5952,5952,0
2021-09-13,CH,24,PL07,205753,188780,21645,4672,16973
2021-11-29,HO,18,PL40,64096,63848,296,296,0
2021-03-26,CH,24,PL08,117659,115402,7224,4416,2808
2021-11-26,HO,18,PL40,56088,55744,344,344,0
2021-04-30,EC,10,PL43,159344,158240,1168,1168,0
2021-04-08,EC,10,PL43,593280,585792,7488,7488,0
2021-10-14,CH,24,PL57,25700,25556,144,144,0
2021-02-03,SD,13,PL19,65653,63998,1940,192,1748
2021-11-28,HO,18,PL33,72168,71992,224,224,0
2021-05-23,HO,18,PL09,70368,69336,1048,1048,0
2021-10-06,PR,15,PL24,262496,260960,1632,1632,0
2021-12-17,HO,18,PL03,4256,2880,1376,1376,0
2021-06-30,CH,24,PL07,9941,9406,13301,2752,10549
2021-08-23,SD,13,PL22,74145,74022,2006,1696,310
2021-02-13,CL,14,PL45,303808,297728,544,544,0
2021-02-17,SD,13,PL19,65425,64321,2406,1280,1126
2021-03-15,HO,18,PL03,64368,64296,104,104,0
2021-10-02,RT,21,PL42,53568,52288,1280,1280,0
2021-01-24,PR,15,PL24,262656,259232,4096,4096,0
2021-07-02,CA,23,PL02,236160,236208,312,312,0
2021-03-26,PR,15,PL04,172224,172224,0,0,0
2021-03-24,CA,23,PL02,230544,228696,2112,2112,0
2021-07-24,HO,18,PL03,41920,41776,192,192,0
2021-06-12,DI,19,PL52,291136,289824,1760,1760,0
2021-06-28,HO,18,PL09,72480,72384,96,96,0
2021-03-09,CH,24,PL07,172970,169379,9040,5280,3760
2021-03-01,SB,11,PL50,3712,0,3712,3712,0
2021-08-15,PR,15,PL12,118336,118208,176,176,0
2021-11-15,SD,13,PL19,73356,73204,728,560,168
2021-04-30,SD,13,PL18,73624,73452,576,384,192
2021-11-19,CA,23,PL13,74248,74248,688,688,0
2021-01-24,SD,13,PL20,74352,74172,932,752,180
2021-05-20,PW,26,PL37,808608,808416,1920,1920,0
2021-05-08,SB,11,PL36,309000,303744,5424,5424,0
2021-01-28,SD,13,PL21,72479,70727,1944,192,1752
2021-07-23,CH,24,PL08,303335,302078,3405,1856,1549
2021-11-02,SD,13,PL25,59869,58566,1847,544,1303
2021-11-19,SD,13,PL17,44599,44506,369,192,177
2021-07-20,SD,13,PL20,76328,76296,235,176,59
2021-10-04,HO,18,PL03,67056,66936,120,120,0
2021-04-17,PR,15,PL24,211680,210816,1088,1088,0
2021-09-13,DI,19,PL52,204640,203680,1248,1248,0
2021-01-23,HO,18,PL33,67624,67608,88,88,0
2021-01-06,PR,15,PL04,263840,264096,384,384,0
2021-09-22,HO,18,PL03,66856,66744,192,192,0
2021-10-13,HO,18,PL30,0,0,656,656,0
2021-08-11,CA,23,PL02,165984,163560,2736,2736,0
2021-07-23,EC,10,PL43,629712,627072,2544,2544,0
2021-06-08,CA,23,PL13,8400,8400,0,0,0
2021-04-07,EC,10,PL43,577296,555120,22512,22512,0
2021-02-03,SD,13,PL20,29572,29522,255,192,63
2021-06-13,RA,17,PL35,222816,220584,2232,2232,0
2021-04-30,RT,21,PL05,190560,190800,288,288,0
2021-02-19,CL,14,PL44,299488,274656,4992,4992,0
2021-08-06,EC,10,PL43,628992,627792,2640,2640,0
2021-01-06,CL,14,PL44,301824,298784,2048,2048,0
2021-12-10,DI,19,PL52,215584,215040,9344,9344,0
2021-04-11,SB,11,PL50,457216,455488,3232,3232,0
2021-12-21,PB,25,PL55,448896,446528,2368,2368,0
2021-09-30,SD,13,PL17,73914,73750,788,544,244
2021-05-29,CA,23,PL31,231264,229752,1704,1704,0
2021-05-04,HO,18,PL32,64736,64792,144,144,0
2021-12-06,RA,17,PL56,259344,259056,528,528,0
2021-01-04,PRG,12,PL14,389920,387232,3392,3392,0
2021-04-11,CA,23,PL13,85032,85056,88,88,0
2021-09-25,RT,21,PL41,92608,88480,4176,4176,0
2021-12-09,SB,11,PL36,309384,306696,3072,3072,0
2021-10-15,CH,24,PL57,34076,34064,44,44,0
2021-02-05,SB,11,PL36,183120,178800,4320,4320,0
2021-11-17,PRG,12,PL12,327520,325472,2464,2464,0
2021-08-06,CH,24,PL57,34292,34248,44,44,0
2021-09-10,SD,13,PL17,66208,66061,3491,3344,147
2021-04-23,RA,17,PL56,182688,182136,552,552,0
2021-07-06,HO,18,PL01,18656,18320,336,336,0
2021-04-04,HO,18,PL09,49256,47568,1688,1688,0
2021-03-27,EC,10,PL43,0,0,18816,18816,0
2021-10-21,RT,21,PL42,54384,0,54384,54384,0
2021-05-30,HO,18,PL03,66464,66320,144,144,0
2021-06-28,HO,18,PL33,127840,127408,432,432,0
2021-10-03,HO,18,PL11,66120,65856,312,312,0
2021-01-30,CA,23,PL02,206112,197736,8808,8808,0
2021-06-24,HO,18,PL30,65400,65344,120,120,0
2021-02-15,CH,24,PL04,164672,164432,240,240,0
2021-04-11,HO,18,PL32,65728,65496,232,232,0
2021-09-28,SD,13,PL22,71201,71097,776,672,104
2021-12-19,RA,17,PL56,259608,259080,528,528,0
2021-05-17,PW,26,PL37,771552,760128,11760,11760,0
2021-04-06,RT,21,PL05,161280,156528,16968,16968,0
2021-09-24,CH,24,PL07,289021,285579,9016,5248,3768
2021-11-27,SD,13,PL20,75752,75596,348,192,156
2021-06-23,CH,24,PL57,30636,30592,44,44,0
2021-09-20,HO,18,PL56,62736,62144,592,592,0
2021-04-26,NT,16,PL51,467680,467680,512,512,0
2021-06-22,HO,18,PL32,68600,68600,0,0,0
2021-06-22,CA,23,PL02,233112,232824,816,816,0
2021-09-12,HO,18,PL03,66160,66128,88,88,0
2021-01-15,HO,18,PL32,0,0,832,832,0
2021-03-03,SD,13,PL19,72888,72114,1894,1040,854
2021-11-29,NT,16,PL51,279232,278880,736,736,0
2021-01-26,PW,26,PL37,780192,754608,26544,26544,0
2021-10-05,SB,11,PL50,11136,0,11136,11136,0
2021-07-05,HO,18,PL01,42448,42080,424,424,0
2021-03-19,RT,21,PL06,209448,208680,768,768,0
2021-02-05,HO,18,PL32,67168,66912,552,552,0
2021-03-19,HO,18,PL10,56664,56560,192,192,0
2021-04-20,SD,13,PL22,65711,65272,730,192,538
2021-11-09,PB,25,PL54,436864,431520,6880,6880,0
2021-10-25,SD,13,PL18,74982,74477,886,368,518
2021-05-04,DI,19,PL52,289024,289056,2688,2688,0
2021-10-05,CH,24,PL12,164256,164368,224,224,0
2021-09-27,SD,13,PL17,73686,73436,810,560,250
2021-09-20,CH,24,PL07,78510,75591,10055,7136,2919
2021-03-04,SD,13,PL19,74645,73402,1835,592,1243
2021-11-25,RT,21,PL06,122784,120216,2592,2592,0
2021-01-13,RA,17,PL34,196200,191280,5040,5040,0
2021-11-02,HO,18,PL56,65944,65464,480,480,0
2021-01-05,SD,13,PL21,72071,70383,2072,384,1688
2021-04-11,EC,10,PL43,617280,616944,816,816,0
2021-07-22,HO,18,PL01,64400,64056,432,432,0
2021-01-14,PR,15,PL04,263168,262720,672,672,0
2021-06-28,DI,19,PL52,219840,219744,224,224,0
2021-01-19,RA,17,PL35,220800,220656,312,312,0
2021-02-13,PR,15,PL24,262944,262144,928,928,0
2021-11-22,RT,21,PL41,124848,114608,10576,10576,0
2021-01-02,RT,21,PL05,127008,124536,2472,2472,0
2021-08-10,SB,11,PL36,308712,307416,1296,1296,0
2021-07-30,RT,21,PL05,203136,202656,672,672,0
2021-11-14,CL,14,PL44,275904,261408,7488,7488,0
2021-09-03,CA,23,PL02,230568,229224,1680,1680,0
2021-02-07,PR,15,PL24,264160,261056,3360,3360,0
2021-01-15,RA,17,PL35,221160,220320,864,864,0
2021-02-05,SD,13,PL18,71304,70801,731,176,555
2021-01-04,PB,25,PL55,22240,11040,14432,14432,0
2021-08-13,SD,13,PL18,75804,75570,444,192,252
2021-03-18,CA,23,PL02,76440,74112,4440,4440,0
2021-04-26,CL,14,PL44,231776,199424,4832,4832,0
2021-06-06,PB,25,PL54,395200,395520,800,800,0
2021-08-20,CH,24,PL08,314255,301907,15114,2656,12458
2021-07-16,HO,18,PL01,67160,67192,88,88,0
2021-09-17,SD,13,PL18,68261,67850,1387,976,411
2021-11-29,SD,13,PL18,70320,69429,1083,192,891
2021-11-24,HO,18,PL10,66808,66808,1360,1360,0
2021-07-24,CL,14,PL44,183328,181696,1856,1856,0
2021-04-14,SD,13,PL18,67233,66783,882,432,450
2021-07-15,PB,25,PL54,446720,446592,1632,1632,0
2021-05-14,PB,25,PL55,435776,431744,8544,8544,0
2021-06-01,RA,17,PL34,219696,219864,288,288,0
2021-06-25,CA,23,PL02,223728,220344,3792,3792,0
2021-09-14,RT,21,PL06,19656,13512,6144,6144,0
2021-05-01,CH,24,PL08,320246,293776,31301,4544,26757
2021-03-29,PR,15,PL04,196672,196576,864,864,0
2021-07-12,PR,15,PL12,139440,139056,384,384,0
2021-12-18,CA,23,PL35,79088,79056,96,96,0
2021-07-19,HO,18,PL10,68632,68488,224,224,0
2021-04-27,SD,13,PL19,72195,72210,645,624,21
2021-02-22,HO,18,PL01,50976,50456,632,632,0
2021-03-01,SD,13,PL22,6150,6138,12,0,12
2021-03-14,CH,24,PL07,297732,292593,8845,3552,5293
2021-03-28,HO,18,PL10,12584,12104,536,536,0
2021-09-21,CH,24,PL12,164864,164720,272,272,0
2021-09-23,HO,18,PL56,64736,64072,728,728,0
2021-02-19,PB,25,PL55,448000,448160,1152,1152,0
2021-01-29,RT,21,PL06,205824,205392,720,720,0
2021-09-25,CL,14,PL44,304448,301568,2336,2336,0
2021-06-09,HO,18,PL10,54400,54264,136,136,0
2021-06-02,CH,24,PL08,272418,241412,45470,14464,31006
2021-07-22,RT,21,PL05,204816,203280,1704,1704,0
2021-01-21,RA,17,PL56,186072,184560,1656,1656,0
2021-02-12,HO,18,PL10,56968,56944,96,96,0
2021-05-01,RA,17,PL35,153048,149520,3528,3528,0
2021-11-09,SD,13,PL22,0,0,992,992,0
2021-07-17,HO,18,PL56,64656,63880,808,808,0
2021-03-16,DI,19,PL53,298400,297888,928,928,0
2021-04-22,CH,24,PL12,156992,156752,608,608,0
2021-02-23,SD,13,PL20,75385,75150,989,688,301
2021-07-27,EC,10,PL43,141408,122976,18240,18240,0
2021-10-11,HO,18,PL32,57040,57000,88,88,0
2021-01-08,SD,13,PL17,72896,72808,595,464,131
2021-05-28,CH,24,PL08,219106,214815,33923,29632,4291
2021-11-28,SD,13,PL21,65257,64852,581,176,405
2021-05-05,SD,13,PL18,74325,73749,670,176,494
2021-06-02,CA,23,PL13,72128,69992,2224,2224,0
2021-01-14,SD,13,PL25,71497,70263,1315,0,1315
2021-01-03,PR,15,PL24,254112,253344,1184,1184,0
2021-09-19,CL,14,PL45,289952,285088,3264,3264,0
2021-10-29,SD,13,PL17,21490,21390,101,0,101
2021-02-06,RA,17,PL56,217848,215352,2856,2856,0
2021-01-10,SD,13,PL18,69461,67666,2018,208,1810
2021-02-06,SD,13,PL21,73208,71649,1735,176,1559
2021-05-18,HO,18,PL09,72584,72608,88,88,0
2021-06-17,HO,18,PL03,712,0,712,712,0
2021-09-27,RT,21,PL06,201648,201768,384,384,0
2021-06-15,EC,10,PL43,622608,618672,3648,3648,0
2021-08-28,CA,23,PL02,229464,228912,912,912,0
2021-12-02,CL,14,PL45,281056,271040,5248,5248,0
2021-11-22,CH,24,PL08,277888,273792,5472,5472,0
2021-01-22,PRG,12,PL14,0,0,30528,30528,0
2021-04-30,SD,13,PL17,73695,73325,760,384,376
2021-03-28,SD,13,PL18,71983,70677,1677,368,1309
2021-08-08,HO,18,PL40,66016,65784,232,232,0
2021-05-03,PR,15,PL04,262624,262656,448,448,0
2021-10-22,HO,18,PL03,66864,66680,88,88,0
2021-01-08,HO,18,PL33,66960,66904,176,176,0
2021-10-26,CH,24,PL57,34192,34188,44,44,0
2021-08-13,HO,18,PL40,65920,64752,1168,1168,0
2021-01-25,SD,13,PL25,68909,68613,1096,800,296
2021-11-08,HO,18,PL40,66152,66080,112,112,0
2021-10-13,DI,19,PL53,293280,293728,992,992,0
2021-11-30,RT,21,PL05,112656,104904,8616,8616,0
2021-03-31,SD,13,PL18,58271,56493,2251,384,1867
2021-11-30,CA,23,PL13,52168,48008,4160,4160,0
2021-03-28,RT,21,PL06,203424,201888,1896,1896,0
2021-06-10,PB,25,PL55,251392,247008,5312,5312,0
2021-10-28,RT,21,PL42,186032,174800,11856,11856,0
2021-11-11,PB,25,PL54,341888,335584,27584,27584,0
2021-08-04,CA,23,PL02,199080,198432,768,768,0
2021-11-05,CH,24,PL07,307058,302879,10055,5760,4295
2021-09-20,DI,19,PL52,287584,286880,832,832,0
2021-04-24,CH,24,PL07,314865,305928,11561,2624,8937
2021-09-30,HO,18,PL30,0,0,1376,1376,0
2021-05-21,PW,26,PL37,459408,458064,34080,34080,0
2021-09-24,SD,13,PL21,57693,57365,1104,768,336
2021-02-11,DI,19,PL53,276736,275456,1472,1472,0
2021-07-20,CA,23,PL31,197544,194472,3096,3096,0
2021-02-13,SD,13,PL17,74433,72283,2166,16,2150
2021-04-23,RT,21,PL06,171240,169752,5544,5544,0
2021-09-15,SD,13,PL25,70243,69208,1724,656,1068
2021-09-01,HO,18,PL03,67024,66784,232,232,0
2021-07-23,HO,18,PL33,66224,66224,0,0,0
2021-01-06,HO,18,PL33,68704,68776,0,0,0
2021-10-04,CA,23,PL31,219384,215304,4416,4416,0
2021-11-23,SD,13,PL25,57829,56869,2962,1904,1058
2021-04-14,RT,21,PL42,181440,177264,4176,4176,0
2021-05-04,SD,13,PL18,72849,72827,510,384,126
2021-05-27,SD,13,PL21,73537,73572,514,176,338
2021-02-09,SB,11,PL36,270168,269808,2736,2736,0
2021-04-16,HO,18,PL33,33728,32896,832,832,0
2021-09-08,CA,23,PL02,226488,225648,1488,1488,0
2021-06-04,CA,23,PL02,224712,224112,864,864,0
2021-07-12,RT,21,PL05,203904,203784,432,432,0
2021-08-31,HO,18,PL09,65824,65328,656,656,0
2021-05-11,DI,19,PL53,258848,258528,4448,4448,0
2021-04-27,PW,26,PL37,756192,755232,2064,2064,0
2021-06-04,RT,21,PL05,175920,176208,1152,1152,0
2021-02-10,CL,14,PL45,295072,282464,6624,6624,0
2021-06-25,DI,19,PL52,262144,261408,1440,1440,0
2021-11-26,CA,23,PL02,141120,139608,1512,1512,0
2021-03-29,SD,13,PL22,54738,54670,436,368,68
2021-06-04,HO,18,PL03,47640,47536,400,400,0
2021-07-31,RT,21,PL42,183024,180544,2576,2576,0
2021-02-26,EC,10,PL43,624240,623040,1200,1200,0
2021-07-19,SD,13,PL18,33317,33182,40695,40560,135
2021-07-26,HO,18,PL10,23296,21848,2840,2840,0
2021-04-28,PR,15,PL57,105744,105040,800,800,0
2021-09-07,SD,13,PL18,70224,69949,835,560,275
2021-05-11,CA,23,PL13,82064,81792,360,360,0
2021-12-09,PW,26,PL37,757344,741696,16608,16608,0
2021-04-24,CH,24,PL12,159008,158592,592,592,0
2021-11-18,SD,13,PL20,72932,72803,788,656,132
2021-04-29,SB,11,PL50,40864,40800,3264,3264,0
2021-05-04,PR,15,PL04,248608,241664,7296,7296,0
2021-10-16,DI,19,PL53,248032,246624,2240,2240,0
2021-12-11,CA,23,PL31,180456,172992,7464,7464,0
2021-01-30,RT,21,PL05,182952,180648,2520,2520,0
2021-01-30,PR,15,PL57,142432,142368,368,368,0
2021-02-22,RT,21,PL06,207912,207792,264,264,0
2021-03-12,PB,25,PL55,447392,447616,1760,1760,0
2021-04-08,PB,25,PL54,446944,443360,4416,4416,0
2021-11-12,PW,26,PL37,814752,814320,1824,1824,0
2021-03-17,HO,18,PL10,32120,31016,1104,1104,0
2021-02-20,SB,11,PL50,458208,455296,3744,3744,0
2021-05-27,PB,25,PL54,368928,351296,17952,17952,0
2021-06-04,CL,14,PL45,296096,286304,4256,4256,0
2021-04-13,RA,17,PL35,223920,223200,720,720,0
2021-10-25,CH,24,PL08,230539,222256,11708,3360,8348
2021-03-15,RA,17,PL35,153000,151128,4728,4728,0
2021-08-31,SD,13,PL18,0,0,6433,6416,17
2021-06-27,SD,13,PL22,72401,71880,1305,784,521
2021-10-13,PR,15,PL04,250624,237504,13120,13120,0
2021-08-08,HO,18,PL30,58584,58176,408,408,0
2021-06-04,PB,25,PL55,444960,440576,5024,5024,0
2021-06-30,SD,13,PL19,30311,30288,404,368,36
2021-11-10,CH,24,PL24,139968,138528,1648,1648,0
2021-02-09,CA,23,PL13,80800,80904,96,96,0
2021-02-27,PB,25,PL55,270432,270272,704,704,0
2021-12-04,RT,21,PL42,47072,44944,2128,2128,0
2021-05-16,CA,23,PL02,201024,195288,5880,5880,0
2021-08-27,PRG,12,PL14,393984,393344,896,896,0
2021-09-04,HO,18,PL03,66568,66456,152,152,0
2021-04-21,SD,13,PL22,24731,24451,8748,8464,284
2021-09-01,RT,21,PL05,183912,183936,288,288,0
2021-01-05,CH,24,PL08,166809,152957,15772,1920,13852
2021-09-22,CH,24,PL07,316259,301526,19471,4416,15055
2021-05-17,CH,24,PL07,271495,256506,18510,3360,15150
2021-06-27,RT,21,PL42,184864,178272,6848,6848,0
2021-03-03,CH,24,PL12,120704,118736,2288,2288,0
2021-07-23,CA,23,PL31,128472,127632,1224,1224,0
2021-11-03,HO,18,PL03,66752,66704,120,120,0
2021-07-19,CA,23,PL31,190704,188856,2184,2184,0
2021-04-03,HO,18,PL01,39680,39152,528,528,0
2021-09-08,CH,24,PL07,43809,41907,5934,4032,1902
2021-02-20,SD,13,PL20,65904,65618,1406,1104,302
2021-11-03,CA,23,PL31,0,0,5016,5016,0
2021-11-24,HO,18,PL09,65664,65448,216,216,0
2021-11-15,HO,18,PL10,68152,68184,88,88,0
2021-06-12,PW,26,PL37,814560,813264,2160,2160,0
2021-11-08,CH,24,PL57,32300,32216,200,200,0
2021-07-18,HO,18,PL40,928,0,928,928,0
2021-05-16,PW,26,PL37,695952,694752,5616,5616,0
2021-02-21,SD,13,PL18,73592,72609,1175,192,983
2021-12-19,SB,11,PL36,310920,308616,2496,2496,0
2021-04-16,RA,17,PL35,165960,162600,3672,3672,0
2021-08-31,CH,24,PL07,265963,264978,7999,6912,1087
2021-10-31,EC,10,PL43,612816,610800,2256,2256,0
2021-10-01,PB,25,PL54,263328,229792,33792,33792,0
2021-03-03,EC,10,PL43,444864,442992,1152,1152,0
2021-09-28,SD,13,PL19,69843,69740,727,624,103
2021-10-25,CA,23,PL02,187656,187032,1464,1464,0
2021-05-25,EC,10,PL43,620160,609216,11184,11184,0
2021-09-23,CH,24,PL57,34020,33952,68,68,0
2021-02-26,HO,18,PL32,67976,67568,408,408,0
2021-09-11,CA,23,PL13,85024,84984,104,104,0
2021-10-02,RA,17,PL34,206520,203376,3480,3480,0
2021-06-20,CA,23,PL31,64608,63864,744,744,0
2021-07-13,PB,25,PL55,310304,298176,12640,12640,0
2021-09-13,DI,19,PL53,290752,289600,1312,1312,0
2021-05-18,RT,21,PL06,210072,209616,456,456,0
2021-09-17,EC,10,PL43,614352,614016,1152,1152,0
2021-03-02,SB,11,PL50,280672,227456,53792,53792,0
2021-09-09,RA,17,PL35,64824,62424,2400,2400,0
2021-09-04,CH,24,PL08,175590,169491,9818,3168,6650
2021-09-25,SD,13,PL21,64720,64438,522,192,330
2021-02-07,NT,16,PL51,460448,453696,7008,7008,0
2021-07-31,SD,13,PL17,72730,71764,1015,0,1015
2021-02-14,SB,11,PL50,455808,452960,3136,3136,0
2021-11-26,HO,18,PL03,0,0,320,320,0
2021-03-22,HO,18,PL30,66224,66224,0,0,0
2021-08-24,HO,18,PL09,69672,69448,224,224,0
2021-08-28,RT,21,PL05,206208,205464,984,984,0
2021-05-05,RA,17,PL34,218544,217608,1056,1056,0
2021-03-02,RA,17,PL34,0,0,0,0,0
2021-11-16,PRG,12,PL12,385472,382656,3008,3008,0
2021-03-30,SD,13,PL22,70837,70772,929,864,65
2021-11-09,CA,23,PL31,156840,153192,4176,4176,0
2021-02-25,SD,13,PL19,45176,44204,986,0,986
2021-06-20,RT,21,PL05,207576,206904,792,792,0
2021-08-14,CL,14,PL44,299616,296384,2752,2752,0
2021-08-17,HO,18,PL01,22952,22840,112,112,0
2021-07-08,SD,13,PL20,75908,75896,238,192,46
2021-10-09,PR,15,PL24,270240,270528,32,32,0
2021-06-22,PB,25,PL55,333792,332288,2272,2272,0
2021-07-01,RA,17,PL35,213600,210048,3672,3672,0
2021-07-04,SB,11,PL50,256160,254720,1440,1440,0
2021-03-20,HO,18,PL09,60248,59328,984,984,0
2021-05-16,SD,13,PL20,69310,69234,550,352,198
2021-02-20,CA,23,PL02,233784,233136,792,792,0
2021-01-20,PRG,12,PL12,390592,390144,1024,1024,0
2021-04-20,CH,24,PL07,208158,196728,24792,13088,11704
2021-04-25,DI,19,PL52,289696,288832,1248,1248,0
2021-01-20,SD,13,PL17,54859,54748,614,480,134
2021-05-31,PR,15,PL04,261696,260352,1504,1504,0
2021-10-16,CA,23,PL02,231336,230880,768,768,0
2021-06-10,SD,13,PL19,70353,69734,5451,4832,619
2021-01-13,SD,13,PL19,63098,62754,536,192,344
2021-02-12,CA,23,PL13,76192,76024,256,256,0
2021-07-02,PR,15,PL04,169888,164832,5248,5248,0
2021-10-16,CH,24,PL08,300100,298343,8741,6784,1957
2021-11-11,CH,24,PL07,190414,187689,11498,8416,3082
2021-03-20,CH,24,PL07,274030,255610,22658,3904,18754
2021-05-01,DI,19,PL53,292544,290944,1760,1760,0
2021-10-06,PRG,12,PL14,392672,392448,864,864,0
2021-07-12,SD,13,PL17,66306,64701,2680,1008,1672
2021-10-25,HO,18,PL33,8448,7120,1328,1328,0
2021-07-08,PW,26,PL37,793920,789600,6624,6624,0
2021-04-13,RT,21,PL06,205464,203952,2472,2472,0
2021-09-22,SD,13,PL22,72226,72163,639,576,63
2021-06-17,HO,18,PL33,131152,130368,784,784,0
2021-07-17,CA,23,PL02,198816,196464,2688,2688,0
2021-11-17,SB,11,PL36,276984,274560,3624,3624,0
2021-12-04,HO,18,PL01,67640,66800,872,872,0
2021-12-12,RT,21,PL05,204576,204528,264,264,0
2021-01-11,SD,13,PL21,69494,68712,1426,592,834
2021-01-04,CA,23,PL02,227112,225552,1680,1680,0
2021-12-07,HO,18,PL33,71928,71896,328,328,0
2021-03-12,CH,24,PL07,298604,293303,10296,4768,5528
2021-09-24,SD,13,PL20,74629,74475,346,192,154
2021-04-20,HO,18,PL10,56472,56432,600,600,0
2021-07-03,HO,18,PL01,67440,66640,800,800,0
2021-01-15,HO,18,PL11,66232,66096,136,136,0
2021-07-17,HO,18,PL10,61656,61472,232,232,0
2021-11-11,RT,21,PL06,181968,180624,2448,2448,0
2021-09-18,HO,18,PL09,46488,45760,728,728,0
2021-07-25,HO,18,PL40,66272,66176,96,96,0
2021-05-05,PB,25,PL55,272736,227360,46080,46080,0
2021-05-19,SD,13,PL22,68824,65529,3807,512,3295
2021-07-22,HO,18,PL10,68168,67912,336,336,0
2021-02-14,SD,13,PL18,50107,49694,637,224,413
2021-03-31,NT,16,PL51,231264,229376,1888,1888,0
2021-04-11,HO,18,PL01,66192,65992,200,200,0
2021-12-01,RT,21,PL42,54288,53136,1344,1344,0
2021-09-07,SD,13,PL21,59464,59125,3171,2832,339
2021-03-11,NT,16,PL51,468192,468192,704,704,0
2021-12-01,CA,23,PL13,84552,84536,312,312,0
2021-03-04,PB,25,PL55,25216,24640,30144,30144,0
2021-05-22,CA,23,PL02,224904,220968,4152,4152,0
2021-09-15,HO,18,PL33,130352,129984,480,480,0
2021-11-08,RT,21,PL06,151368,148968,2400,2400,0
2021-08-21,CH,24,PL07,217692,205806,42670,30784,11886
2021-01-11,HO,18,PL03,66848,66792,96,96,0
2021-05-11,PB,25,PL54,380416,355296,25280,25280,0
2021-07-06,SB,11,PL50,186848,186368,3456,3456,0
2021-08-26,PR,15,PL24,215488,194176,21568,21568,0
2021-07-23,SD,13,PL17,61687,60357,2475,1152,1323
2021-03-13,PB,25,PL55,416672,406016,12096,12096,0
2021-12-10,SD,13,PL19,65695,64685,1449,368,1081
2021-11-12,SD,13,PL20,76634,76522,342,176,166
2021-12-23,SD,13,PL25,10202,10184,18,0,18
2021-07-08,CA,23,PL02,210216,210192,456,456,0
2021-03-30,CH,24,PL12,162096,161024,1280,1280,0
2021-06-25,CA,23,PL31,222696,221112,2160,2160,0
2021-08-13,SD,13,PL20,67218,67120,114,16,98
2021-11-07,PRG,12,PL12,384928,383456,1984,1984,0
2021-04-12,HO,18,PL32,56832,55784,1096,1096,0
2021-06-06,RT,21,PL05,205416,204072,1560,1560,0
2021-12-13,RA,17,PL56,189168,188904,1608,1608,0
2021-02-18,PR,15,PL24,43264,42752,512,512,0
2021-08-08,HO,18,PL33,66136,66168,0,0,0
2021-05-07,SD,13,PL20,72336,72184,695,544,151
2021-06-08,SB,11,PL50,274208,264736,9472,9472,0
2021-10-25,SB,11,PL50,379552,370912,8928,8928,0
2021-10-02,HO,18,PL09,65304,65088,280,280,0
2021-03-20,PB,25,PL55,400320,389824,10912,10912,0
2021-08-02,CH,24,PL07,312991,303434,15584,5696,9888
2021-10-12,PR,15,PL24,259744,258816,928,928,0
2021-06-17,PR,15,PL24,255648,240416,15360,15360,0
2021-09-07,HO,18,PL11,66328,66328,0,0,0
2021-09-21,SD,13,PL19,67238,67032,676,464,212
2021-05-24,EC,10,PL43,610704,608112,2736,2736,0
2021-08-12,SD,13,PL22,67143,67093,487,384,103
2021-12-23,RT,21,PL05,56832,56088,744,744,0
2021-09-27,HO,18,PL56,65640,64232,1408,1408,0
2021-10-31,SB,11,PL50,352832,353120,1024,1024,0
2021-10-20,HO,18,PL03,63200,63064,288,288,0
2021-06-04,CA,23,PL31,227736,226680,1272,1272,0
2021-09-03,HO,18,PL11,65568,65456,112,112,0
2021-11-26,CH,24,PL08,306688,297280,9408,9408,0
2021-04-07,SB,11,PL50,418624,416800,2496,2496,0
2021-03-30,RA,17,PL35,177600,175464,2136,2136,0
2021-06-24,PB,25,PL54,428512,427616,3776,3776,0
2021-01-12,EC,10,PL43,542304,537840,4512,4512,0
2021-05-21,SD,13,PL22,70087,69543,946,384,562
2021-10-21,CH,24,PL07,182912,171431,14809,3328,11481
2021-03-08,RT,21,PL05,205968,205848,552,552,0
2021-01-13,CA,23,PL13,84400,83976,528,528,0
2021-02-25,SD,13,PL20,73874,73537,598,176,422
2021-02-23,HO,18,PL03,65496,65392,104,104,0
2021-07-24,PB,25,PL55,20448,21024,8064,8064,0
2021-11-10,HO,18,PL09,67296,67184,224,224,0
2021-05-08,NT,16,PL51,469664,468608,1344,1344,0
2021-04-23,HO,18,PL01,45168,44976,1056,1056,0
2021-06-03,CH,24,PL08,255485,243752,23119,11168,11951
2021-09-01,SB,11,PL50,340256,339840,1120,1120,0
2021-10-31,DI,19,PL52,294208,293824,960,960,0
2021-03-21,CH,24,PL07,291581,276906,22835,8160,14675
2021-09-16,RT,21,PL42,151792,150944,1136,1136,0
2021-01-02,RA,17,PL56,73848,72432,1416,1416,0
2021-12-15,HO,18,PL01,67896,67176,744,744,0
2021-04-06,PB,25,PL55,423328,418016,12960,12960,0
2021-06-17,DI,19,PL52,261344,259328,2464,2464,0
2021-11-18,PW,26,PL37,813648,813456,2112,2112,0
2021-07-03,CH,24,PL08,279902,265878,25672,11648,14024
2021-02-14,PB,25,PL55,447840,446368,4096,4096,0
2021-06-27,HO,18,PL30,66224,66224,0,0,0
2021-01-24,HO,18,PL32,66512,65808,784,784,0
2021-10-16,HO,18,PL33,129168,129008,160,160,0
2021-01-27,EC,10,PL43,627840,626688,1104,1104,0
2021-02-10,NT,16,PL51,464480,460672,4736,4736,0
2021-10-20,SB,11,PL50,296928,284000,13888,13888,0
2021-02-02,NT,16,PL51,109120,104192,4832,4832,0
2021-09-06,SD,13,PL19,74547,74523,792,768,24
2021-05-19,CA,23,PL31,210432,208056,2520,2520,0
2021-10-20,CH,24,PL08,13486,8559,4927,0,4927
2021-11-26,SD,13,PL17,68234,68031,1092,832,260
2021-06-08,SD,13,PL22,63231,62707,1163,560,603
2021-05-20,NT,16,PL51,468736,468416,1440,1440,0
2021-06-06,RA,17,PL34,220536,219624,912,912,0
2021-05-22,HO,18,PL01,63376,63208,192,192,0
2021-12-02,SD,13,PL19,58885,58650,635,400,235
2021-11-10,EC,10,PL43,603216,579840,23568,23568,0
2021-08-06,RT,21,PL42,132016,123888,8128,8128,0
2021-11-19,HO,18,PL40,66080,65744,336,336,0
2021-01-29,HO,18,PL10,57056,57000,112,112,0
2021-05-31,PW,26,PL37,793920,789792,4464,4464,0
2021-02-23,HO,18,PL10,56928,56872,104,104,0
2021-02-26,CH,24,PL07,276055,268624,20743,13312,7431
2021-06-20,PR,15,PL04,267456,265056,2592,2592,0
2021-10-04,CH,24,PL57,34220,34200,44,44,0
2021-01-04,CH,24,PL08,306594,301312,14370,9088,5282
2021-03-15,SD,13,PL18,31683,31109,622,48,574
2021-12-14,PB,25,PL55,347872,328288,20192,20192,0
2021-05-10,RA,17,PL35,156552,152376,4176,4176,0
2021-08-10,CH,24,PL07,256345,229917,35452,9024,26428
2021-11-06,CL,14,PL44,304128,301760,1568,1568,0
2021-07-12,SD,13,PL18,66942,66690,3276,3024,252
2021-06-15,RT,21,PL05,206376,202872,3576,3576,0
2021-04-10,NT,16,PL51,463360,463296,800,800,0
2021-10-09,CA,23,PL13,84768,84864,192,192,0
2021-07-25,HO,18,PL56,32648,32632,16,16,0
2021-10-09,RT,21,PL06,205512,204888,624,624,0
2021-08-05,HO,18,PL03,66848,66328,608,608,0
2021-07-04,CA,23,PL02,234624,234216,1008,1008,0
2021-06-21,CH,24,PL57,34240,34240,48,48,0
2021-08-02,SD,13,PL19,61237,61215,1142,1104,38
2021-09-11,EC,10,PL43,623232,622752,576,576,0
2021-10-28,RT,21,PL41,169584,155424,14352,14352,0
2021-09-09,PB,25,PL55,0,0,544,544,0
2021-05-21,RT,21,PL42,187408,183968,3584,3584,0
2021-12-11,SD,13,PL22,72437,72228,561,352,209
2021-11-09,HO,18,PL56,66040,65880,160,160,0
2021-02-02,CA,23,PL31,57984,57360,624,624,0
2021-06-20,HO,18,PL33,132464,132464,0,0,0
2021-06-19,SD,13,PL22,67812,66242,2689,1056,1633
2021-03-21,CA,23,PL02,217944,214992,2808,2808,0
2021-08-15,EC,10,PL43,244704,244608,48,48,0
2021-10-30,RA,17,PL34,91992,90936,4704,4704,0
2021-06-11,CA,23,PL31,37944,37824,216,216,0
2021-10-14,CL,14,PL44,296416,292480,2144,2144,0
2021-09-20,SB,11,PL50,373792,372928,3392,3392,0
2021-10-11,SD,13,PL17,58841,58699,543,368,175
2021-04-27,HO,18,PL30,62280,62224,104,104,0
2021-06-27,PB,25,PL55,444672,444416,1184,1184,0
2021-09-07,HO,18,PL03,67456,67120,360,360,0
2021-01-28,CA,23,PL02,235416,231720,3984,3984,0
2021-03-24,RA,17,PL35,0,0,1488,1488,0
2021-10-17,SD,13,PL22,48960,48896,2640,2576,64
2021-05-16,PR,15,PL04,224160,180608,44352,44352,0
2021-08-17,PRG,12,PL14,134656,134496,160,160,0
2021-04-30,CA,23,PL13,85480,85504,96,96,0
2021-03-03,CL,14,PL45,236128,215648,7328,7328,0
2021-03-07,HO,18,PL03,65088,64512,576,576,0
2021-12-01,CH,24,PL57,33992,33964,44,44,0
2021-11-03,SB,11,PL36,92280,88248,4032,4032,0
2021-10-29,RT,21,PL42,28256,11264,16992,16992,0
2021-03-07,CH,24,PL12,159632,158016,2224,2224,0
2021-04-13,RT,21,PL42,138176,135536,6544,6544,0
2021-01-21,PW,26,PL37,44736,38352,6384,6384,0
2021-06-13,HO,18,PL30,65488,65384,104,104,0
2021-10-10,PW,26,PL37,815376,815040,1152,1152,0
2021-08-31,PR,15,PL24,168992,154272,15200,15200,0
2021-03-02,SD,13,PL20,71766,71418,892,544,348
2021-09-12,PR,15,PL24,262880,261824,1408,1408,0
2021-06-02,PR,15,PL24,118048,117760,2528,2528,0
2021-07-19,PW,26,PL37,79152,78624,40896,40896,0
2021-10-21,SD,13,PL19,42147,41045,5824,4704,1120
2021-06-09,HO,18,PL01,63712,62784,928,928,0
2021-12-16,RA,17,PL56,213288,212904,1632,1632,0
2021-12-03,CH,24,PL12,142416,142208,464,464,0
2021-11-10,HO,18,PL32,57656,57656,0,0,0
2021-06-12,PR,15,PL04,259072,257056,2272,2272,0
2021-07-01,CH,24,PL07,146262,140337,11454,5056,6398
2021-07-01,CA,23,PL02,160032,158592,1440,1440,0
2021-09-04,SD,13,PL21,70404,70070,526,192,334
2021-08-29,RT,21,PL05,151320,151296,1488,1488,0
2021-04-30,SD,13,PL22,75092,74452,771,16,755
2021-10-18,SD,13,PL25,75933,75316,661,0,661
2021-03-31,PB,25,PL55,424256,423200,1696,1696,0
2021-05-03,SD,13,PL17,73459,73072,659,272,387
2021-04-12,CA,23,PL02,230568,230184,744,744,0
2021-09-04,HO,18,PL01,66848,66008,1032,1032,0
2021-05-22,SB,11,PL36,291768,289104,3072,3072,0
2021-04-15,PR,15,PL57,143168,142976,384,384,0
2021-12-11,SD,13,PL18,64672,64077,4083,3488,595
2021-02-13,CH,24,PL08,321632,318624,3008,3008,0
2021-07-29,SD,13,PL22,65038,64971,433,352,81
2021-05-28,CH,24,PL07,173001,156873,24640,8512,16128
2021-08-12,RT,21,PL05,178608,178032,1872,1872,0
2021-09-03,SD,13,PL22,68700,68599,488,352,136
2021-03-31,HO,18,PL32,63680,63600,152,152,0
2021-12-18,CA,23,PL02,232032,231552,864,864,0
2021-09-17,SD,13,PL19,71513,71470,44,0,44
2021-01-17,HO,18,PL09,72568,72488,96,96,0
2021-10-21,HO,18,PL33,132528,132528,0,0,0
2021-02-19,HO,18,PL09,63800,63504,296,296,0
2021-09-10,HO,18,PL33,132480,132480,0,0,0
2021-02-02,HO,18,PL30,66160,66160,0,0,0
2021-02-11,DI,19,PL52,296576,296800,416,416,0
2021-03-20,HO,18,PL30,58432,58240,192,192,0
2021-02-16,PRG,12,PL12,391904,391488,832,832,0
2021-08-06,SD,13,PL18,73204,72662,740,192,548
2021-09-27,HO,18,PL11,66152,65680,472,472,0
2021-01-19,PRG,12,PL12,388672,388800,1984,1984,0
2021-11-18,SD,13,PL21,62798,62191,814,192,622
2021-03-06,CH,24,PL04,79520,79296,224,224,0
2021-03-21,PB,25,PL55,447168,447552,1408,1408,0
2021-12-04,PW,26,PL37,812304,813072,1200,1200,0
2021-01-08,PR,15,PL24,265184,264544,928,928,0
2021-03-01,HO,18,PL09,58840,58744,96,96,0
2021-03-20,SD,13,PL17,60832,60632,1570,1328,242
2021-07-30,SD,13,PL19,63880,63781,594,480,114
2021-05-05,RA,17,PL56,219504,218472,1296,1296,0
2021-05-08,HO,18,PL30,63656,63104,552,552,0
2021-07-08,HO,18,PL32,42240,41856,384,384,0
2021-09-20,SD,13,PL17,76197,75269,1133,192,941
2021-02-03,DI,19,PL52,0,0,1504,1504,0
2021-05-21,HO,18,PL30,60200,59824,376,376,0
2021-02-17,PB,25,PL55,448288,443744,5312,5312,0
2021-11-08,EC,10,PL43,620544,613536,7056,7056,0
2021-01-06,SD,13,PL19,76107,75943,232,0,232
2021-10-02,RT,21,PL41,80,0,80,80,0
2021-12-09,SD,13,PL18,65518,64862,1224,496,728
2021-01-04,EC,10,PL43,81648,80720,752,752,0
2021-08-29,HO,18,PL01,41568,40752,816,816,0
2021-01-16,RA,17,PL34,184776,183072,1872,1872,0
2021-03-08,HO,18,PL01,63144,62872,504,504,0
2021-10-02,SD,13,PL19,75543,75397,908,720,188
2021-10-24,CA,23,PL31,234576,233016,1848,1848,0
2021-04-15,HO,18,PL03,63208,63136,696,696,0
2021-07-25,RT,21,PL42,181664,163056,19872,19872,0
2021-04-22,PR,15,PL04,267040,265920,1472,1472,0
2021-10-01,SB,11,PL50,452864,427808,25568,25568,0
2021-01-09,HO,18,PL32,65112,65048,88,88,0
2021-05-10,SB,11,PL36,214128,213624,32520,32520,0
2021-05-30,RA,17,PL35,224184,222216,2160,2160,0
2021-09-04,HO,18,PL33,131968,129600,2368,2368,0
2021-10-22,CH,24,PL57,33700,33616,120,120,0
2021-10-07,PB,25,PL55,438080,429632,10048,10048,0
2021-09-22,CA,23,PL02,221472,221208,624,624,0
2021-05-08,PRG,12,PL14,389952,389984,1088,1088,0
2021-06-15,SB,11,PL50,432896,431200,1984,1984,0
2021-01-13,NT,16,PL51,467584,464064,3520,3520,0
2021-05-07,PR,15,PL04,267296,267328,64,64,0
2021-06-27,CL,14,PL44,300128,298176,1888,1888,0
2021-03-12,SD,13,PL19,68618,68319,1968,1664,304
2021-05-03,SD,13,PL18,58531,58127,580,176,404
2021-07-22,SD,13,PL17,70275,67921,2729,368,2361
2021-08-28,SD,13,PL21,72093,71675,1218,800,418
2021-06-30,RA,17,PL35,194976,194712,264,264,0
2021-10-03,HO,18,PL03,67624,67624,0,0,0
2021-03-30,DI,19,PL52,294400,294080,640,640,0
2021-04-14,RA,17,PL56,174408,173256,1344,1344,0
2021-09-30,DI,19,PL52,245120,245184,2880,2880,0
2021-05-14,HO,18,PL03,67064,66976,88,88,0
2021-06-27,PRG,12,PL14,391712,391168,768,768,0
2021-11-15,PW,26,PL37,813648,812496,1632,1632,0
2021-03-29,HO,18,PL30,66136,66208,0,0,0
2021-08-08,SD,13,PL19,69773,69872,2742,2624,118
2021-06-01,DI,19,PL53,293664,291392,2976,2976,0
2021-07-18,SD,13,PL19,63030,62981,577,528,49
2021-10-24,SD,13,PL20,76305,76119,445,176,269
2021-05-17,SD,13,PL25,58106,57667,652,176,476
2021-05-27,CL,14,PL45,302880,301792,736,736,0
2021-01-03,SD,13,PL21,71668,69880,2380,576,1804
2021-10-06,SB,11,PL36,312528,311232,1800,1800,0
2021-07-12,HO,18,PL09,71536,71432,232,232,0
2021-10-10,DI,19,PL53,294976,294496,864,864,0
2021-06-15,SD,13,PL21,69789,69202,4875,4288,587
2021-11-16,CL,14,PL45,293440,290112,2848,2848,0
2021-02-25,CH,24,PL04,163008,162592,416,416,0
2021-04-10,PB,25,PL54,388736,379904,9856,9856,0
2021-01-26,HO,18,PL03,65336,65104,608,608,0
2021-09-08,SB,11,PL50,456640,455232,2112,2112,0
2021-08-04,PB,25,PL54,383296,380000,8000,8000,0
2021-02-27,CH,24,PL04,164416,164496,208,208,0
2021-03-24,SD,13,PL22,71445,71275,1918,1712,206
2021-07-25,CL,14,PL44,302976,298912,2144,2144,0
2021-10-21,HO,18,PL32,56640,56424,200,200,0
2021-04-14,HO,18,PL11,62928,62816,304,304,0
2021-04-25,CL,14,PL44,154528,130528,2400,2400,0
2021-07-31,CH,24,PL07,285412,269267,26336,9888,16448
2021-10-06,HO,18,PL11,43464,43032,432,432,0
2021-09-25,CA,23,PL02,209040,208656,552,552,0
2021-04-09,CH,24,PL08,246538,232081,23865,9408,14457
2021-06-28,HO,18,PL03,67032,66800,232,232,0
2021-06-24,NT,16,PL51,450656,449472,2432,2432,0
2021-01-15,SD,13,PL25,67685,67407,986,720,266
2021-09-06,SD,13,PL21,60965,60616,818,432,386
2021-04-02,HO,18,PL01,66232,66128,104,104,0
2021-03-30,HO,18,PL10,10760,8448,2368,2368,0
2021-01-27,RA,17,PL56,0,0,0,0,0
2021-09-21,SD,13,PL22,70842,70825,435,384,51
2021-03-30,CL,14,PL45,301568,295872,1824,1824,0
2021-06-23,HO,18,PL01,68264,68240,16,16,0
2021-09-06,HO,18,PL01,63744,63384,360,360,0
2021-11-03,RA,17,PL34,75936,40920,35016,35016,0
2021-07-12,CH,24,PL08,307898,303976,10388,6336,4052
2021-05-29,PRG,12,PL14,389344,388768,832,832,0
2021-05-18,PB,25,PL54,426144,407584,20256,20256,0
2021-09-17,PB,25,PL54,0,0,3296,3296,0
2021-01-17,HO,18,PL11,56144,56048,96,96,0
2021-09-29,SD,13,PL19,75909,75836,481,384,97
2021-10-05,CA,23,PL02,228072,226992,1128,1128,0
2021-10-26,CH,24,PL07,279541,273914,10907,5280,5627
2021-06-17,RT,21,PL05,176304,175920,3456,3456,0
2021-11-13,DI,19,PL52,162368,162240,448,448,0
2021-11-08,SD,13,PL21,62550,62056,512,0,512
2021-05-18,RT,21,PL05,207936,207216,1224,1224,0
2021-03-29,PW,26,PL37,771024,769008,3264,3264,0
2021-05-29,PB,25,PL55,445440,444352,3136,3136,0
2021-03-01,NT,16,PL51,388736,384704,4416,4416,0
2021-02-15,HO,18,PL03,66224,66224,0,0,0
2021-07-24,RT,21,PL42,9440,9040,12912,12912,0
2021-12-16,SD,13,PL21,68441,67969,1384,912,472
2021-11-18,CA,23,PL31,216192,211416,5208,5208,0
2021-07-20,RT,21,PL41,21744,14912,6832,6832,0
2021-12-18,SD,13,PL18,63992,63246,1642,576,1066
2021-03-19,PR,15,PL24,263904,263520,640,640,0
2021-01-10,HO,18,PL32,63704,63704,0,0,0
2021-02-04,PR,15,PL24,252928,244992,8704,8704,0
2021-01-05,CA,23,PL02,174600,171312,3768,3768,0
2021-11-16,RA,17,PL34,258120,256272,1944,1944,0
2021-02-14,HO,18,PL33,66904,66296,736,736,0
2021-03-02,PR,15,PL24,260352,258624,2240,2240,0
2021-12-07,RA,17,PL56,213696,210936,2760,2760,0
2021-11-29,DI,19,PL52,293152,292992,416,416,0
2021-05-08,DI,19,PL52,286144,285440,1888,1888,0
2021-01-09,HO,18,PL33,68208,68168,88,88,0
2021-03-31,RT,21,PL06,195648,195456,840,840,0
2021-09-10,SD,13,PL22,72089,71997,476,384,92
2021-11-07,RA,17,PL34,237024,234144,2880,2880,0
2021-03-20,HO,18,PL10,50984,50840,208,208,0
2021-08-10,PB,25,PL55,59296,0,95424,95424,0
2021-04-23,PR,15,PL04,263712,262176,1920,1920,0
2021-09-02,PB,25,PL54,442176,437184,5600,5600,0
2021-05-09,PR,15,PL04,264352,263776,576,576,0
2021-03-22,RA,17,PL34,179232,178560,1896,1896,0
2021-05-15,PRG,12,PL14,358592,358496,11616,11616,0
2021-08-09,SB,11,PL36,310992,309984,1632,1632,0
2021-02-14,RA,17,PL35,220776,220296,528,528,0
2021-03-27,CA,23,PL13,80464,80456,192,192,0
2021-01-23,HO,18,PL09,72208,72128,120,120,0
2021-03-08,CL,14,PL45,218304,206016,4896,4896,0
2021-10-02,PR,15,PL04,266688,265472,1376,1376,0
2021-02-08,SB,11,PL50,413568,410752,5504,5504,0
2021-10-21,RT,21,PL05,159048,158568,1296,1296,0
2021-07-20,CA,23,PL11,0,0,976,976,0
2021-04-15,CH,24,PL12,155664,155632,848,848,0
2021-05-10,PW,26,PL37,783888,773664,11856,11856,0
2021-11-01,HO,18,PL40,63496,63208,288,288,0
2021-02-01,SD,13,PL25,70242,68750,2100,592,1508
2021-03-13,RT,21,PL05,206088,206016,384,384,0
2021-07-19,CL,14,PL44,288704,279520,2400,2400,0
2021-01-06,SD,13,PL17,73116,72870,454,208,246
2021-03-22,HO,18,PL09,62520,61752,816,816,0
2021-05-29,CL,14,PL45,297696,290688,6176,6176,0
2021-10-08,RA,17,PL34,260352,258384,2304,2304,0
2021-11-26,PW,26,PL37,680832,679728,1872,1872,0
2021-03-29,CL,14,PL44,296000,291168,1344,1344,0
2021-06-20,CH,24,PL57,34240,34180,60,60,0
2021-09-07,HO,18,PL01,34856,34296,648,648,0
2021-06-11,SD,13,PL19,38221,36538,4931,3200,1731
2021-12-11,RT,21,PL05,208512,208008,528,528,0
2021-06-07,CL,14,PL45,186656,142304,23968,23968,0
2021-09-30,HO,18,PL11,66288,66200,88,88,0
2021-05-19,HO,18,PL09,72720,72688,96,96,0
2021-03-23,HO,18,PL33,66152,66216,0,0,0
2021-01-27,CA,23,PL13,77280,77136,176,176,0
2021-05-21,CA,23,PL13,81584,80832,824,824,0
2021-12-19,SD,13,PL17,74965,72180,3094,208,2886
2021-05-01,HO,18,PL33,66136,66168,0,0,0
2021-10-25,SD,13,PL22,68082,68028,1040,960,80
2021-03-11,SD,13,PL19,73021,70703,3999,1600,2399
2021-12-14,SD,13,PL17,0,0,1341,944,397
2021-10-28,SD,13,PL25,10476,10299,1302,352,950
2021-01-04,CH,24,PL07,0,0,4174,4128,46
2021-11-23,SB,11,PL36,295488,294120,1872,1872,0
2021-11-09,HO,18,PL10,67680,67640,136,136,0
2021-10-08,DI,19,PL53,291616,289216,2848,2848,0
2021-01-23,HO,18,PL32,65832,65328,608,608,0
2021-09-10,RT,21,PL05,208368,208608,0,0,0
2021-12-03,CA,23,PL31,179664,172464,7824,7824,0
2021-01-18,HO,18,PL10,57008,56920,88,88,0
2021-10-17,RT,21,PL06,202416,202248,408,408,0
2021-01-20,CA,23,PL31,234072,233400,960,960,0
2021-05-09,CL,14,PL45,291872,285952,4000,4000,0
2021-11-17,CA,23,PL31,157992,156648,1680,1680,0
2021-05-24,HO,18,PL09,69008,67960,1032,1032,0
2021-05-08,SD,13,PL22,74079,73811,1272,896,376
2021-02-15,PR,15,PL24,189728,187264,2464,2464,0
2021-11-19,CH,24,PL24,118640,116080,2880,2880,0
2021-11-26,RT,21,PL42,148144,145824,2432,2432,0
2021-03-27,HO,18,PL30,61480,60000,1496,1496,0
2021-12-15,CH,24,PL12,161664,161856,1328,1328,0
2021-09-30,CH,24,PL07,305040,301719,10986,7232,3754
2021-09-06,SD,13,PL18,75940,75622,734,416,318
2021-07-07,PW,26,PL37,814080,810528,4320,4320,0
2021-03-12,CH,24,PL08,10203,10156,14831,14784,47
2021-02-16,SD,13,PL19,41665,40356,3831,2400,1431
2021-07-31,CL,14,PL44,294016,292192,1504,1504,0
2021-10-11,PW,26,PL37,802848,801600,3120,3120,0
2021-07-07,EC,10,PL43,625344,624720,576,576,0
2021-10-20,HO,18,PL40,66288,66288,0,0,0
2021-12-23,HO,18,PL33,14312,14312,0,0,0
2021-08-17,CH,24,PL07,86083,83384,7772,4896,2876
2021-01-10,PR,15,PL24,267840,267456,576,576,0
2021-10-19,HO,18,PL09,19648,19536,128,128,0
2021-09-01,PB,25,PL55,0,0,448,448,0
2021-09-19,SB,11,PL36,309024,306312,3072,3072,0
2021-10-23,HO,18,PL01,64408,63512,928,928,0
2021-02-02,CL,14,PL44,105408,103680,32,32,0
2021-10-30,DI,19,PL52,247392,238976,8608,8608,0
2021-01-29,SB,11,PL50,335072,330880,6464,6464,0
2021-03-25,HO,18,PL30,66144,66208,0,0,0
2021-09-24,PRG,12,PL14,391808,391264,768,768,0
2021-04-28,CA,23,PL13,85408,85352,168,168,0
2021-02-10,RA,17,PL34,193848,188616,5640,5640,0
2021-05-21,HO,18,PL33,63384,63176,208,208,0
2021-08-15,SD,13,PL17,42041,41980,533,384,149
2021-08-14,SD,13,PL18,68661,68395,4938,4672,266
2021-04-07,SD,13,PL22,75318,75259,293,208,85
2021-06-10,CH,24,PL07,128407,122635,9614,3840,5774
2021-12-02,HO,18,PL03,66176,66072,104,104,0
2021-11-16,RT,21,PL41,146992,137120,9872,9872,0
2021-02-19,RT,21,PL06,191832,186480,5544,5544,0
2021-02-28,SD,13,PL18,65226,64210,1555,384,1171
2021-09-10,SD,13,PL19,76556,76471,261,176,85
2021-05-21,SD,13,PL20,42386,42110,3585,3296,289
2021-12-03,DI,19,PL52,227904,228096,0,0,0
2021-05-22,RT,21,PL06,166464,162240,4296,4296,0
2021-08-01,CL,14,PL44,299008,296832,1664,1664,0
2021-10-07,SB,11,PL36,184032,182448,1584,1584,0
2021-07-28,CH,24,PL07,198769,186802,18825,6848,11977
2021-03-22,SD,13,PL20,58164,57949,997,768,229
2021-06-25,RT,21,PL42,187104,176336,12128,12128,0
2021-12-07,PRG,12,PL14,0,0,768,768,0
2021-02-10,SD,13,PL20,71117,69818,1918,528,1390
2021-01-30,DI,19,PL52,299264,299424,0,0,0
2021-10-20,HO,18,PL33,126912,124016,2896,2896,0
2021-11-11,PW,26,PL37,818448,817632,1248,1248,0
2021-03-29,CA,23,PL31,232248,231504,1152,1152,0
2021-04-21,PR,15,PL24,263584,262144,2016,2016,0
2021-02-01,CH,24,PL04,92304,91520,1216,1216,0
2021-11-22,SD,13,PL22,75164,75133,431,400,31
2021-11-23,SD,13,PL21,63570,63179,556,176,380
2021-06-24,RA,17,PL34,162360,161328,1032,1032,0
2021-02-25,SD,13,PL22,72024,71651,917,544,373
2021-05-11,HO,18,PL40,67688,67640,120,120,0
2021-06-16,HO,18,PL32,68520,68384,136,136,0
2021-09-09,HO,18,PL09,71720,71544,376,376,0
2021-09-05,PB,25,PL54,440448,438336,4128,4128,0
2021-11-22,CH,24,PL24,157088,156672,752,752,0
2021-01-02,RA,17,PL34,130920,126912,4416,4416,0
2021-11-20,PR,15,PL04,263904,263584,480,480,0
2021-01-18,CL,14,PL44,31872,22272,4256,4256,0
2021-01-08,PRG,12,PL12,39424,39360,64,64,0
2021-01-22,SD,13,PL17,57432,56679,2519,1744,775
2021-02-23,CA,23,PL31,220584,218304,2544,2544,0
2021-11-14,PR,15,PL04,261792,261856,384,384,0
2021-03-22,SD,13,PL19,3829,3704,2666,1648,1018
2021-09-21,CH,24,PL57,34112,34144,68,68,0
2021-09-26,HO,18,PL33,84528,82192,2336,2336,0
2021-11-24,DI,19,PL53,262944,260608,2560,2560,0
2021-06-14,CA,23,PL11,231888,227664,4416,4416,0
2021-06-11,RA,17,PL34,220392,219120,1392,1392,0
2021-03-23,HO,18,PL09,68872,68328,624,624,0
2021-11-01,PB,25,PL54,372928,361344,12384,12384,0
2021-07-21,CH,24,PL08,298065,294476,7141,3552,3589
2021-10-15,PR,15,PL04,261312,256256,5472,5472,0
2021-03-09,HO,18,PL01,64648,63680,1136,1136,0
2021-02-07,PR,15,PL57,142912,142960,192,192,0
2021-04-26,HO,18,PL10,57024,56936,88,88,0
2021-09-13,EC,10,PL43,564288,563088,2544,2544,0
2021-05-16,HO,18,PL40,59032,58800,544,544,0
2021-05-26,CA,23,PL11,229608,226968,2880,2880,0
2021-08-23,PR,15,PL24,261952,258016,4064,4064,0
2021-03-12,CH,24,PL12,104192,101712,3568,3568,0
2021-10-30,RT,21,PL41,73392,62944,10448,10448,0
2021-10-28,CL,14,PL45,292832,288800,3200,3200,0
2021-05-22,CH,24,PL07,308456,297324,15096,3904,11192
2021-04-09,SD,13,PL25,63532,62284,1781,528,1253
2021-04-24,HO,18,PL09,71712,71152,584,584,0
2021-08-06,HO,18,PL33,66224,66224,0,0,0
2021-01-12,SD,13,PL22,70985,70854,499,368,131
2021-04-10,CL,14,PL44,294176,278496,8640,8640,0
2021-06-28,RT,21,PL41,8288,6224,2064,2064,0
2021-06-25,RT,21,PL05,204768,204336,672,672,0
2021-09-20,SB,11,PL36,304584,302904,1992,1992,0
2021-12-06,CH,24,PL12,159152,158112,1072,1072,0
2021-01-21,CL,14,PL44,78016,76800,32,32,0
2021-08-19,SD,13,PL19,66362,65704,1073,176,897
2021-11-03,RT,21,PL42,167392,165056,2496,2496,0
2021-09-12,PB,25,PL55,167520,119488,48416,48416,0
2021-11-02,SD,13,PL22,67527,67382,1201,992,209
2021-02-24,RA,17,PL56,185496,182544,2952,2952,0
2021-01-28,PR,15,PL57,124160,123872,496,496,0
2021-03-10,NT,16,PL57,154704,154560,192,192,0
2021-07-15,HO,18,PL10,54240,53496,792,792,0
2021-12-04,CH,24,PL12,164656,164608,176,176,0
2021-06-23,SD,13,PL18,8035,7932,5095,4992,103
2021-03-16,CH,24,PL12,162304,162544,256,256,0
2021-02-03,SD,13,PL22,72846,72588,450,192,258
2021-04-15,HO,18,PL11,66288,66288,0,0,0
2021-11-17,RT,21,PL42,178176,174112,5808,5808,0
2021-04-06,SD,13,PL22,59891,59785,7178,7008,170
2021-05-12,RT,21,PL42,160144,138480,21856,21856,0
2021-06-25,HO,18,PL10,56688,55712,976,976,0
2021-05-07,CA,23,PL31,234384,234024,768,768,0
2021-07-21,CL,14,PL45,247584,244224,9216,9216,0
2021-09-15,SD,13,PL18,1062,1060,929,16,913
2021-03-05,DI,19,PL52,284480,283232,1536,1536,0
2021-07-10,PB,25,PL54,131392,111296,20736,20736,0
2021-09-19,HO,18,PL32,57352,57216,136,136,0
2021-11-08,PW,26,PL37,816960,815760,1632,1632,0
2021-05-10,DI,19,PL52,36160,33696,2464,2464,0
2021-10-16,CA,23,PL31,227208,224400,3072,3072,0
2021-03-20,HO,18,PL01,59088,58792,336,336,0
2021-02-27,CH,24,PL08,216518,209307,19064,9728,9336
2021-02-17,PW,26,PL37,815856,810528,6048,6048,0
2021-06-01,SD,13,PL21,69097,68325,1124,352,772
2021-10-10,CA,23,PL02,182352,182472,600,600,0
2021-10-14,HO,18,PL40,66216,66096,120,120,0
2021-03-12,PW,26,PL37,812880,811824,2256,2256,0
2021-03-04,HO,18,PL03,66208,66056,152,152,0
2021-02-15,HO,18,PL01,56872,56048,1008,1008,0
2021-09-03,SD,13,PL25,70967,70107,1404,544,860
2021-11-19,CH,24,PL07,301015,282846,22521,4352,18169
2021-05-19,HO,18,PL10,56536,56040,576,576,0
2021-06-30,HO,18,PL30,66128,66160,0,0,0
2021-10-23,RT,21,PL05,207072,206280,792,792,0
2021-01-29,SD,13,PL18,68381,67575,1230,400,830
2021-11-30,PRG,12,PL54,0,0,17888,17888,0
2021-02-23,RT,21,PL41,43632,13520,30112,30112,0
2021-11-21,RT,21,PL41,177728,168256,9328,9328,0
2021-05-08,PB,25,PL54,303168,196256,106912,106912,0
2021-11-12,HO,18,PL32,55992,55848,280,280,0
2021-11-11,SD,13,PL18,63725,62891,3743,2896,847
2021-01-04,PR,15,PL04,266912,266304,960,960,0
2021-01-03,HO,18,PL03,38696,38528,344,344,0
2021-04-16,SD,13,PL19,69798,69765,592,512,80
2021-01-14,SD,13,PL19,48346,48038,1015,608,407
2021-10-19,HO,18,PL01,65128,64544,744,744,0
2021-10-01,SD,13,PL22,76708,76542,166,0,166
2021-02-14,PRG,12,PL12,390176,390048,736,736,0
2021-05-10,HO,18,PL40,67368,67232,136,136,0
2021-10-23,CH,24,PL07,218965,214475,8522,4032,4490
2021-06-25,RA,17,PL35,190824,190176,960,960,0
2021-01-31,RT,21,PL06,209568,209592,240,240,0
2021-05-12,SD,13,PL18,62398,62145,1133,880,253
2021-05-29,PR,15,PL04,265024,264992,544,544,0
2021-05-05,SD,13,PL22,75108,74849,436,176,260
2021-04-16,PRG,12,PL14,352384,344864,8672,8672,0
2021-07-10,CA,23,PL02,8304,8304,0,0,0
2021-06-25,PRG,12,PL14,386592,386176,992,992,0
2021-12-14,SD,13,PL19,68796,68647,553,384,169
2021-06-30,SD,13,PL17,71449,70569,1254,352,902
2021-11-06,NT,16,PL51,510368,510112,1152,1152,0
2021-12-17,HO,18,PL33,69200,67560,1640,1640,0
2021-08-11,PR,15,PL24,263040,263168,704,704,0
2021-01-22,SD,13,PL25,69512,69220,484,192,292
2021-02-09,SD,13,PL18,37829,37354,1214,368,846
2021-03-21,RA,17,PL35,150192,148920,1272,1272,0
2021-11-30,HO,18,PL40,59432,59312,120,120,0
2021-05-21,CL,14,PL44,287264,280928,5664,5664,0
2021-09-28,CL,14,PL45,286912,275232,4224,4224,0
2021-10-05,CL,14,PL45,288704,282560,4448,4448,0
2021-05-18,HO,18,PL32,67744,67640,160,160,0
2021-05-21,EC,10,PL43,329520,309696,9456,9456,0
2021-11-15,CL,14,PL45,278528,271296,6144,6144,0
2021-03-09,HO,18,PL09,59944,58088,2112,2112,0
2021-05-07,PB,25,PL55,424608,405920,23072,23072,0
2021-04-28,PB,25,PL55,373152,372000,2976,2976,0
2021-10-03,SD,13,PL19,72272,71968,1456,1152,304
2021-02-23,EC,10,PL43,626400,625008,1152,1152,0
2021-08-03,CH,24,PL07,246561,235967,16898,6240,10658
2021-11-13,CL,14,PL45,297472,294112,2176,2176,0
2021-10-25,SD,13,PL19,76340,76164,368,192,176
2021-11-09,PR,15,PL04,265216,264160,1248,1248,0
2021-11-10,NT,16,PL51,514304,514016,736,736,0
2021-10-17,PW,26,PL37,813552,813360,1296,1296,0
2021-02-09,PRG,12,PL12,373184,373760,0,0,0
2021-10-21,HO,18,PL03,67832,67904,120,120,0
2021-03-24,HO,18,PL01,60816,60440,808,808,0
2021-09-09,SD,13,PL20,72312,72251,461,400,61
2021-01-26,CA,23,PL02,233064,229032,4728,4728,0
2021-03-07,NT,16,PL51,451648,451456,768,768,0
2021-06-08,SD,13,PL17,73004,72945,828,192,636
2021-11-13,SD,13,PL17,70292,70213,341,176,165
2021-10-13,CH,24,PL57,22812,22212,600,600,0
2021-08-17,CA,23,PL31,58464,56568,1896,1896,0
2021-02-14,NT,16,PL51,467232,465600,1888,1888,0
2021-09-13,HO,18,PL01,67080,66144,952,952,0
2021-06-30,PB,25,PL54,436576,419008,17920,17920,0
2021-02-19,DI,19,PL53,252704,251648,1216,1216,0
2021-03-19,RA,17,PL35,158904,158184,768,768,0
2021-11-03,SD,13,PL22,21,5,16,0,16
2021-10-24,CH,24,PL08,315544,307552,11032,3040,7992
2021-04-12,DI,19,PL52,153952,153024,3968,3968,0
2021-02-05,HO,18,PL09,72328,72176,152,152,0
2021-09-17,DI,19,PL52,289184,288640,736,736,0
2021-12-05,HO,18,PL10,68712,68624,144,144,0
2021-04-26,PRG,12,PL14,388192,387328,992,992,0
2021-08-15,PB,25,PL55,430400,425440,6112,6112,0
2021-03-06,CA,23,PL31,211752,211008,768,768,0
2021-06-09,SD,13,PL17,50975,50548,1289,368,921
2021-02-16,NT,16,PL51,470176,469664,864,864,0
2021-09-29,CA,23,PL02,165264,163464,2280,2280,0
2021-11-23,HO,18,PL32,21544,21560,0,0,0
2021-12-12,HO,18,PL32,57224,57144,88,88,0
2021-08-03,SD,13,PL18,71523,71124,2800,2336,464
2021-02-18,CH,24,PL08,306784,302208,4800,4800,0
2021-03-01,SB,11,PL36,155880,150600,5352,5352,0
2021-03-16,CA,23,PL31,233040,232704,840,840,0
2021-01-27,RA,17,PL35,187296,184248,3048,3048,0
2021-01-18,SD,13,PL25,62376,62128,2401,2112,289
2021-03-07,SD,13,PL22,73187,73046,317,176,141
2021-06-14,HO,18,PL09,72192,72112,80,80,0
2021-07-27,CH,24,PL07,2528,2067,461,0,461
2021-11-10,RA,17,PL35,261456,259272,2184,2184,0
2021-03-11,HO,18,PL03,66232,66232,0,0,0
2021-07-24,CA,23,PL31,76368,76056,768,768,0
2021-07-17,HO,18,PL01,66640,65864,776,776,0
2021-07-21,CH,24,PL07,0,0,191,0,191
2021-10-11,DI,19,PL52,289664,289184,896,896,0
2021-05-31,RT,21,PL42,190432,182960,7552,7552,0
2021-08-25,SD,13,PL22,75551,75558,549,480,69
2021-03-19,SD,13,PL19,52094,51422,7950,7248,702
2021-08-07,SD,13,PL20,1626,426,1433,176,1257
2021-12-21,RT,21,PL06,204456,203688,888,888,0
2021-08-06,CH,24,PL08,13115,13014,11226,4896,6330
2021-09-27,PR,15,PL24,270208,270208,160,160,0
2021-05-28,PRG,12,PL14,393056,391776,1504,1504,0
2021-05-07,NT,16,PL51,405056,404992,1056,1056,0
2021-06-17,PB,25,PL55,441024,438432,3776,3776,0
2021-11-19,RT,21,PL42,26720,25840,864,864,0
2021-01-09,PR,15,PL24,260704,259136,1952,1952,0
2021-03-12,CL,14,PL44,296704,291840,2848,2848,0
2021-01-20,SB,11,PL50,383808,379328,5504,5504,0
2021-07-24,RT,21,PL06,0,0,0,0,0
2021-06-19,CL,14,PL45,296960,294016,1824,1824,0
2021-05-18,SD,13,PL20,73095,73018,901,736,165
2021-07-08,HO,18,PL30,64528,64240,328,328,0
2021-10-19,SD,13,PL21,51519,51313,608,384,224
2021-01-04,PRG,12,PL12,377184,372960,4768,4768,0
2021-04-12,HO,18,PL01,64216,63752,464,464,0
2021-03-08,SB,11,PL50,452288,449024,3968,3968,0
2021-11-22,HO,18,PL10,66488,66288,88,88,0
2021-05-31,HO,18,PL30,65312,65232,168,168,0
2021-07-15,CL,14,PL44,274688,272224,2176,2176,0
2021-07-12,CA,23,PL02,127440,127032,4992,4992,0
2021-03-18,PRG,12,PL14,106912,73728,33184,33184,0
2021-05-15,RA,17,PL34,207480,206568,1152,1152,0
2021-03-23,SD,13,PL21,70517,70124,1554,1120,434
2021-02-02,HO,18,PL09,73160,73264,0,0,0
2021-02-11,CA,23,PL02,235032,231312,4128,4128,0
2021-04-06,PR,15,PL24,177728,177056,2048,2048,0
2021-06-08,EC,10,PL43,620832,619776,1488,1488,0
2021-11-04,CL,14,PL44,298528,295104,2720,2720,0
2021-08-15,SD,13,PL18,65437,64759,1337,528,809
2021-02-16,RT,21,PL06,207096,205536,1824,1824,0
2021-05-11,PB,25,PL55,441920,437600,8640,8640,0
2021-05-27,DI,19,PL52,280096,280032,576,576,0
2021-01-11,EC,10,PL43,595872,588480,7056,7056,0
2021-09-21,HO,18,PL09,68328,68232,96,96,0
2021-02-07,DI,19,PL53,275840,274432,1408,1408,0
2021-06-09,EC,10,PL43,636048,634368,1728,1728,0
2021-05-29,HO,18,PL30,66128,66200,0,0,0
2021-05-24,PB,25,PL55,421056,414880,6560,6560,0
2021-08-18,CA,23,PL31,0,0,0,0,0
2021-08-11,HO,18,PL33,66224,66224,0,0,0
2021-02-12,SD,13,PL25,13557,11151,7414,5008,2406
2021-02-28,HO,18,PL11,66288,66288,0,0,0
2021-04-28,SD,13,PL21,70134,69479,1071,416,655
2021-11-27,SB,11,PL36,89232,57384,31848,31848,0
2021-10-16,HO,18,PL11,63464,63152,360,360,0
2021-08-28,SD,13,PL18,76302,75858,956,496,460
2021-03-05,NT,16,PL51,467968,467136,1344,1344,0
2021-09-30,HO,18,PL56,66192,66072,120,120,0
2021-12-03,SB,11,PL36,271728,270624,3696,3696,0
2021-10-24,HO,18,PL40,57608,56208,1400,1400,0
2021-05-02,PW,26,PL37,767664,753696,15024,15024,0
2021-01-23,RA,17,PL56,221808,220176,1632,1632,0
2021-04-14,PR,15,PL04,264928,264896,832,832,0
2021-03-10,CA,23,PL31,229272,228384,984,984,0
2021-11-10,CA,23,PL02,233976,233496,888,888,0
2021-01-26,HO,18,PL01,66288,66288,0,0,0
2021-11-01,CH,24,PL57,34048,34024,44,44,0
2021-02-23,SB,11,PL36,310896,310320,1200,1200,0
2021-02-20,HO,18,PL01,64552,62640,1984,1984,0
2021-09-26,CL,14,PL45,241696,215200,22656,22656,0
2021-02-28,RA,17,PL35,205464,201768,3696,3696,0
2021-12-10,RT,21,PL06,205992,205896,528,528,0
2021-02-15,CH,24,PL07,234353,227818,8777,1920,6857
2021-05-24,CH,24,PL08,264276,257497,22043,15264,6779
2021-06-25,PR,15,PL04,266816,264704,2208,2208,0
2021-06-28,SD,13,PL25,72931,72454,879,368,511
2021-10-25,HO,18,PL56,65376,65336,96,96,0
2021-08-26,RT,21,PL05,208488,208680,0,0,0
2021-12-04,CA,23,PL31,225792,221448,4704,4704,0
2021-03-11,SD,13,PL22,71801,71578,2047,1824,223
2021-03-08,RA,17,PL34,218256,216768,1896,1896,0
2021-04-08,CA,23,PL02,209088,206952,2544,2544,0
2021-04-24,PR,15,PL24,267904,267616,672,672,0
2021-06-17,DI,19,PL53,294848,294880,768,768,0
2021-03-16,SD,13,PL22,68896,68726,2298,2128,170
2021-01-16,EC,10,PL43,615792,613296,2640,2640,0
2021-07-06,CL,14,PL44,275488,272928,2208,2208,0
2021-11-16,HO,18,PL40,66304,66304,0,0,0
2021-03-18,SD,13,PL20,73372,73129,842,560,282
2021-11-13,HO,18,PL11,65592,65296,296,296,0
2021-06-25,SD,13,PL22,71163,70668,911,416,495
2021-12-01,HO,18,PL30,137840,133088,4752,4752,0
2021-01-07,DI,19,PL52,288192,287680,992,992,0
2021-06-05,PB,25,PL54,284288,243712,40736,40736,0
2021-07-21,RT,21,PL06,0,0,0,0,0
2021-03-09,RT,21,PL06,194544,194040,360,360,0
2021-03-31,HO,18,PL09,71472,71392,368,368,0
2021-02-21,CH,24,PL04,164480,164208,512,512,0
2021-07-11,EC,10,PL43,634560,633504,1296,1296,0
2021-09-27,CH,24,PL07,235384,232071,7615,3872,3743
2021-11-03,CA,23,PL13,85640,85544,96,96,0
2021-11-11,HO,18,PL40,37432,37008,424,424,0
2021-03-01,CL,14,PL45,292512,262304,8576,8576,0
2021-12-23,HO,18,PL01,17520,17520,0,0,0
2021-09-13,PB,25,PL55,376128,344864,31680,31680,0
2021-06-14,EC,10,PL43,372336,371328,1248,1248,0
2021-03-11,DI,19,PL53,195744,195776,2848,2848,0
2021-05-21,DI,19,PL53,284640,281856,2976,2976,0
2021-09-28,HO,18,PL03,67624,67624,0,0,0
2021-04-27,RA,17,PL34,54720,54072,912,912,0
2021-06-25,SD,13,PL17,69199,67588,2264,608,1656
2021-01-30,CL,14,PL45,294560,283264,2752,2752,0
2021-06-06,SD,13,PL19,64968,63191,1988,176,1812
2021-08-19,SD,13,PL17,0,0,0,0,0
2021-09-16,SB,11,PL36,244824,241896,3072,3072,0
2021-06-11,CA,23,PL02,234696,234288,600,600,0
2021-07-17,HO,18,PL03,7112,6872,240,240,0
2021-08-04,HO,18,PL10,68432,68416,104,104,0
2021-07-28,PB,25,PL54,421088,409984,12000,12000,0
2021-05-11,RA,17,PL56,219576,218424,1488,1488,0
2021-06-08,PRG,12,PL14,390624,390560,928,928,0
2021-08-09,PR,15,PL24,264480,264064,1056,1056,0
2021-07-12,PB,25,PL54,376288,352544,25056,25056,0
2021-07-17,HO,18,PL32,66520,66296,240,240,0
2021-07-07,SD,13,PL25,66947,65219,2181,368,1813
2021-06-22,SB,11,PL36,173592,149928,31752,31752,0
2021-10-15,SB,11,PL36,306480,303216,3312,3312,0
2021-11-05,CH,24,PL08,125608,118297,9647,9408,239
2021-04-16,PR,15,PL24,199488,198848,2048,2048,0
2021-09-06,RT,21,PL42,190624,189888,912,912,0
2021-12-04,PRG,12,PL14,396768,395744,1024,1024,0
2021-10-21,PR,15,PL04,188224,181824,6400,6400,0
2021-06-06,CH,24,PL57,34372,34328,44,44,0
2021-05-12,CA,23,PL31,161112,157632,4200,4200,0
2021-12-06,HO,18,PL32,56808,56720,88,88,0
2021-05-06,CA,23,PL13,85200,85200,104,104,0
2021-08-31,SD,13,PL21,40952,40666,6286,5968,318
2021-05-28,SB,11,PL36,125304,116304,11472,11472,0
2021-12-03,SD,13,PL18,65236,64548,1521,832,689
2021-11-08,RA,17,PL35,262632,260712,2400,2400,0
2021-03-20,NT,16,PL57,138096,137504,784,784,0
2021-06-29,SD,13,PL25,64783,64219,2397,1840,557
2021-10-11,HO,18,PL56,63904,63632,272,272,0
2021-07-20,HO,18,PL30,63304,63328,184,184,0
2021-11-07,SD,13,PL17,66389,66172,393,176,217
2021-04-11,CH,24,PL08,218368,207952,16554,5696,10858
2021-10-21,RA,17,PL35,249864,240456,9624,9624,0
2021-01-14,SB,11,PL36,308856,305688,3648,3648,0
2021-05-05,SD,13,PL21,73604,73025,947,368,579
2021-05-20,SD,13,PL25,71350,71074,667,352,315
2021-11-23,RT,21,PL41,161584,123232,38352,38352,0
2021-09-08,PRG,12,PL14,391200,387904,3872,3872,0
2021-08-17,HO,18,PL09,24528,24432,96,96,0
2021-01-28,PR,15,PL04,12608,12512,96,96,0
2021-01-12,SD,13,PL17,64978,64775,678,432,246
2021-07-29,PB,25,PL54,442176,438528,4672,4672,0
2021-09-08,SD,13,PL22,58523,58419,1695,1456,239
2021-02-01,CH,24,PL07,305170,292666,17464,4960,12504
2021-03-15,HO,18,PL10,57688,57688,0,0,0
2021-02-15,RA,17,PL35,219840,217584,2352,2352,0
2021-06-16,SD,13,PL17,73833,72770,1451,352,1099
2021-06-14,RT,21,PL05,111480,105384,6384,6384,0
2021-10-22,HO,18,PL32,56720,56624,88,88,0
2021-02-14,CA,23,PL13,85256,85016,240,240,0
2021-09-28,CH,24,PL08,296014,292961,10285,7232,3053
2021-06-06,RA,17,PL56,218928,218472,912,912,0
2021-01-31,HO,18,PL03,21240,20968,272,272,0
2021-03-06,HO,18,PL03,65248,65040,312,312,0
2021-05-27,RT,21,PL41,18800,15264,3536,3536,0
2021-09-08,HO,18,PL09,71792,71352,448,448,0
2021-02-23,SB,11,PL50,459744,457824,2304,2304,0
2021-08-21,SD,13,PL22,69916,69916,627,544,83
2021-11-23,HO,18,PL11,36520,36200,520,520,0
2021-08-15,RT,21,PL42,189424,187600,1824,1824,0
2021-09-13,PR,15,PL04,229696,216224,13984,13984,0
2021-11-17,RA,17,PL34,254448,250152,4656,4656,0
2021-08-14,PR,15,PL12,135328,135200,448,448,0
2021-11-25,CH,24,PL08,322816,320544,2592,2592,0
2021-04-12,HO,18,PL03,65600,65552,120,120,0
2021-02-09,SD,13,PL21,57749,55249,3020,384,2636
2021-12-10,HO,18,PL32,57656,57656,0,0,0
2021-10-08,CH,24,PL12,163616,161488,2368,2368,0
2021-07-21,DI,19,PL53,0,0,0,0,0
2021-09-21,SD,13,PL18,69328,68988,916,576,340
2021-01-14,RT,21,PL05,175776,175320,744,744,0
2021-12-16,PR,15,PL04,258016,256736,1664,1664,0
2021-01-25,PB,25,PL55,187808,174560,20640,20640,0
2021-04-09,HO,18,PL32,32696,30624,2072,2072,0
2021-05-09,HO,18,PL01,65384,65080,552,552,0
2021-06-24,HO,18,PL10,55256,52512,2744,2744,0
2021-09-24,PB,25,PL55,308576,284096,24960,24960,0
2021-08-16,HO,18,PL33,24232,24232,0,0,0
2021-03-11,RA,17,PL34,219096,218856,600,600,0
2021-09-13,RA,17,PL35,161544,161064,480,480,0
2021-07-03,HO,18,PL40,66352,66344,8,8,0
2021-09-29,CA,23,PL13,84776,84792,112,112,0
2021-06-22,HO,18,PL40,66328,66328,0,0,0
2021-01-17,EC,10,PL43,618192,612960,5712,5712,0
2021-12-19,SD,13,PL19,74405,74343,301,176,125
2021-08-09,HO,18,PL10,68272,68232,96,96,0
2021-06-01,CA,23,PL02,215136,211008,4344,4344,0
2021-10-28,RA,17,PL35,242568,237240,5352,5352,0
2021-03-14,SD,13,PL18,62083,60394,2554,816,1738
2021-11-02,SD,13,PL20,73889,73423,1122,656,466
2021-01-05,RA,17,PL35,207576,198984,8592,8592,0
2021-06-19,PW,26,PL37,816048,813936,2928,2928,0
2021-11-13,PW,26,PL37,815088,815808,1440,1440,0
2021-07-01,NT,16,PL51,497312,494784,3392,3392,0
2021-06-06,PRG,12,PL14,391680,390624,1728,1728,0
2021-05-28,SD,13,PL20,75246,74845,929,528,401
2021-11-21,HO,18,PL01,66808,66200,608,608,0
2021-09-24,EC,10,PL43,572688,568224,5184,5184,0
2021-01-10,RT,21,PL06,206808,206088,816,816,0
2021-01-03,HO,18,PL33,68160,68032,128,128,0
2021-04-13,HO,18,PL11,66200,66280,0,0,0
2021-12-20,PB,25,PL55,444160,442688,2400,2400,0
2021-06-02,RT,21,PL06,153288,150144,3144,3144,0
2021-04-09,RT,21,PL05,209712,210024,0,0,0
2021-12-17,CA,23,PL02,231792,230952,1008,1008,0
2021-07-08,SD,13,PL17,71932,70878,1246,192,1054
2021-10-11,CH,24,PL12,132032,131824,384,384,0
2021-10-25,HO,18,PL11,66296,66296,0,0,0
2021-03-12,HO,18,PL09,63096,62712,384,384,0
2021-04-11,SD,13,PL25,73859,73612,460,176,284
2021-05-14,EC,10,PL43,179072,178672,352,352,0
2021-01-22,HO,18,PL01,64696,64256,440,440,0
2021-01-20,EC,10,PL43,603696,598800,5520,5520,0
2021-08-03,HO,18,PL11,66280,66296,0,0,0
2021-02-10,HO,18,PL32,68040,67864,264,264,0
2021-07-05,HO,18,PL32,67216,66968,328,328,0
2021-10-03,PR,15,PL24,270176,269792,736,736,0
2021-06-16,RA,17,PL35,221856,220296,2184,2184,0
2021-05-25,PB,25,PL54,415936,410784,5632,5632,0
2021-08-13,HO,18,PL01,46920,44944,1976,1976,0
2021-12-19,CA,23,PL31,231240,228096,3312,3312,0
2021-04-04,HO,18,PL03,49400,49288,112,112,0
2021-04-13,HO,18,PL01,65472,65240,232,232,0
2021-05-19,RT,21,PL42,168000,162016,6128,6128,0
2021-06-30,HO,18,PL09,71992,72032,88,88,0
2021-01-13,SB,11,PL50,387872,371328,17248,17248,0
2021-05-19,CH,24,PL07,274785,263221,17851,6016,11835
2021-10-21,CH,24,PL08,261865,252140,12230,2176,10054
2021-10-07,DI,19,PL53,247040,246208,2976,2976,0
2021-01-23,CH,24,PL57,28616,27456,1168,1168,0
2021-12-22,SD,13,PL18,28389,29433,760,224,536
2021-01-16,SD,13,PL22,65602,64906,1296,576,720
2021-05-10,RT,21,PL06,202008,201264,1944,1944,0
2021-07-20,RT,21,PL05,206880,206304,576,576,0
2021-10-23,SD,13,PL20,76304,76010,376,176,200
2021-01-03,HO,18,PL32,65584,65520,96,96,0
2021-11-16,CH,24,PL24,101280,100656,624,624,0
2021-03-02,SD,13,PL19,68716,68205,1345,832,513
2021-03-16,SD,13,PL21,20388,19820,2232,1664,568
2021-07-17,CL,14,PL44,304960,304128,384,384,0
2021-01-19,SD,13,PL22,68187,67582,1170,560,610
2021-05-12,HO,18,PL10,51152,50904,280,280,0
2021-09-09,SD,13,PL19,72816,72796,1050,992,58
2021-01-05,HO,18,PL01,46248,45424,824,824,0
2021-05-17,SD,13,PL20,76122,75935,187,0,187
2021-05-03,DI,19,PL53,289056,284256,5504,5504,0
2021-01-17,SD,13,PL18,72744,72560,390,192,198
2021-04-13,SD,13,PL22,71571,71453,838,720,118
2021-04-30,CH,24,PL12,161312,161280,192,192,0
2021-04-17,CA,23,PL02,184176,177912,6504,6504,0
2021-09-07,SD,13,PL20,76114,76047,273,192,81
2021-10-23,PB,25,PL55,449824,448704,1280,1280,0
2021-03-07,CL,14,PL45,283680,266432,7424,7424,0
2021-11-15,DI,19,PL52,240768,240896,288,288,0
2021-03-15,CL,14,PL45,262976,242944,3136,3136,0
2021-04-15,HO,18,PL32,67704,67688,96,96,0
2021-06-29,RT,21,PL05,204312,203568,912,912,0
2021-06-06,PR,15,PL24,261184,260512,864,864,0
2021-08-12,SD,13,PL17,74400,74336,725,576,149
2021-12-14,EC,10,PL43,631104,631440,48,48,0
2021-04-27,PRG,12,PL14,372384,371872,992,992,0
2021-06-11,PR,15,PL24,266400,266144,448,448,0
2021-01-05,DI,19,PL53,261792,261632,2144,2144,0
2021-07-27,HO,18,PL40,65568,65184,512,512,0
2021-04-15,HO,18,PL09,72048,71960,176,176,0
2021-11-19,RT,21,PL06,205392,204792,936,936,0
2021-10-09,CH,24,PL07,310701,304352,10990,4416,6574
2021-01-27,CA,23,PL31,182592,181056,1536,1536,0
2021-02-10,PRG,12,PL14,386016,385504,992,992,0
2021-04-12,CL,14,PL44,98592,76320,20960,20960,0
2021-11-06,CH,24,PL08,232704,231104,4736,4736,0
2021-03-17,RT,21,PL05,147024,146736,4176,4176,0
2021-02-08,NT,16,PL51,325824,324192,1888,1888,0
2021-07-11,SD,13,PL20,76481,76419,238,176,62
2021-01-22,SD,13,PL19,62475,62266,385,176,209
2021-02-16,DI,19,PL52,276800,276800,352,352,0
2021-05-15,HO,18,PL03,67360,67248,112,112,0
2021-01-18,PRG,12,PL12,393440,393312,672,672,0
2021-12-20,CH,24,PL12,164672,164352,320,320,0
2021-05-19,RA,17,PL34,220080,219840,504,504,0
2021-07-06,CL,14,PL45,295200,278976,4640,4640,0
2021-03-18,CH,24,PL12,163904,164032,176,176,0
2021-02-14,RT,21,PL06,207864,207600,264,264,0
2021-02-08,CH,24,PL07,87833,79942,18163,10272,7891
2021-06-10,HO,18,PL40,66304,66112,192,192,0
2021-06-25,HO,18,PL01,67552,67456,104,104,0
2021-08-07,PR,15,PL12,139584,139552,176,176,0
2021-07-23,HO,18,PL40,66184,65816,368,368,0
2021-10-30,SB,11,PL36,148128,143184,12408,12408,0
2021-07-09,CA,23,PL31,145272,142968,2520,2520,0
2021-05-09,SD,13,PL25,73662,73345,523,192,331
2021-06-05,RA,17,PL34,219768,219816,456,456,0
2021-05-13,EC,10,PL43,60496,57872,2624,2624,0
2021-12-22,DI,19,PL53,296224,296192,352,352,0
2021-02-22,HO,18,PL10,56096,55976,136,136,0
2021-02-13,PRG,12,PL14,392608,391968,992,992,0
2021-07-02,HO,18,PL01,65936,65632,416,416,0
2021-08-29,SD,13,PL19,67553,67524,398,368,30
2021-11-03,SD,13,PL25,14791,14561,1190,960,230
2021-11-25,CA,23,PL02,70056,69504,2088,2088,0
2021-09-09,HO,18,PL01,68264,67960,304,304,0
2021-02-04,CH,24,PL04,159776,159392,416,416,0
2021-04-22,HO,18,PL03,9136,8704,432,432,0
2021-04-28,NT,16,PL51,375552,375872,576,576,0
2021-02-02,SD,13,PL20,2485,2453,1776,1744,32
2021-09-17,CH,24,PL07,149812,139927,16072,5856,10216
2021-11-27,CA,23,PL31,209256,207384,2256,2256,0
2021-09-02,PR,15,PL04,329120,327936,1728,1728,0
2021-03-12,SD,13,PL25,73803,73730,265,192,73
2021-10-27,HO,18,PL03,66968,66864,128,128,0
2021-01-22,SB,11,PL50,284160,283360,25344,25344,0
2021-12-15,RT,21,PL42,191040,189296,1888,1888,0
2021-03-24,PR,15,PL24,262752,262176,1248,1248,0
2021-07-09,CA,23,PL02,232272,232200,288,288,0
2021-12-23,RT,21,PL06,8424,8424,0,0,0
2021-05-04,HO,18,PL09,67872,67872,104,104,0
2021-10-15,HO,18,PL03,67144,67048,96,96,0
2021-10-11,PRG,12,PL14,383264,382368,1088,1088,0
2021-01-15,RT,21,PL06,203928,202848,1080,1080,0
2021-03-17,PR,15,PL04,264000,263328,1024,1024,0
2021-02-22,SD,13,PL20,73560,73275,925,640,285
2021-03-29,CH,24,PL12,38752,38352,1808,1808,0
2021-01-24,PRG,12,PL12,395008,394432,864,864,0
2021-10-12,HO,18,PL32,3696,3696,0,0,0
2021-10-31,PB,25,PL54,448192,434528,13952,13952,0
2021-03-27,HO,18,PL10,54192,53928,264,264,0
2021-06-22,CA,23,PL11,234072,233592,792,792,0
2021-09-01,NT,16,PL51,351520,352032,896,896,0
2021-09-22,DI,19,PL53,246976,245664,1504,1504,0
2021-06-22,PR,15,PL12,139024,138880,464,464,0
2021-03-01,HO,18,PL01,66216,66048,168,168,0
2021-11-12,PRG,12,PL14,391712,391008,896,896,0
2021-05-06,CA,23,PL11,208272,207552,1344,1344,0
2021-03-16,PRG,12,PL14,384992,379520,6720,6720,0
2021-01-18,HO,18,PL30,66080,66152,0,0,0
2021-03-31,SB,11,PL50,231616,231552,544,544,0
2021-05-02,RT,21,PL05,209760,209904,0,0,0
2021-11-17,SD,13,PL25,68860,68062,1851,992,859
2021-08-31,HO,18,PL03,66552,66312,320,320,0
2021-02-04,RT,21,PL06,206040,205752,600,600,0
2021-09-18,SD,13,PL17,71968,71786,775,592,183
2021-10-02,SD,13,PL18,76097,75417,1050,352,698
2021-02-06,HO,18,PL32,68624,68488,136,136,0
2021-02-17,SD,13,PL20,59426,59131,1063,768,295
2021-02-21,RA,17,PL34,198696,197520,1200,1200,0
2021-08-20,SD,13,PL22,76280,76205,267,192,75
2021-08-07,HO,18,PL56,64096,63024,1112,1112,0
2021-09-07,RA,17,PL34,223488,221712,1776,1776,0
2021-10-16,HO,18,PL56,65360,65256,104,104,0
2021-05-05,CH,24,PL12,164016,164000,416,416,0
2021-09-27,HO,18,PL10,69152,69256,0,0,0
2021-05-28,NT,16,PL51,391104,388672,3488,3488,0
2021-05-03,SD,13,PL22,73516,73173,896,448,448
2021-02-15,HO,18,PL10,53800,52688,1152,1152,0
2021-04-08,CA,23,PL13,84872,84888,80,80,0
2021-01-14,PB,25,PL55,450368,444704,6976,6976,0
2021-03-30,EC,10,PL43,287664,279744,8976,8976,0
2021-09-20,CH,24,PL08,216480,208294,17461,9056,8405
2021-12-21,CA,23,PL31,117480,116928,1248,1248,0
2021-12-04,HO,18,PL32,56736,56440,296,296,0
2021-11-21,CH,24,PL08,268384,264288,4096,4096,0
2021-06-12,HO,18,PL30,66224,66192,32,32,0
2021-01-30,PRG,12,PL12,390688,390336,768,768,0
2021-12-18,PB,25,PL55,431264,417888,13856,13856,0
2021-03-15,SD,13,PL20,62213,61909,1158,848,310
2021-05-02,RT,21,PL06,205512,205368,384,384,0
2021-01-15,PRG,12,PL12,394176,393664,736,736,0
2021-08-22,SD,13,PL25,74809,74020,981,192,789
2021-05-23,PB,25,PL54,443584,444064,1440,1440,0
2021-03-30,HO,18,PL09,71816,71768,96,96,0
2021-07-28,RT,21,PL41,0,0,0,0,0
2021-12-21,HO,18,PL03,3320,3176,144,144,0
2021-06-21,CH,24,PL08,111609,110389,6373,4640,1733
2021-09-24,SD,13,PL17,72595,72360,2044,1808,236
2021-12-06,SD,13,PL20,44494,43966,5972,5440,532
2021-05-19,SB,11,PL36,281088,279600,1824,1824,0
2021-07-23,SD,13,PL18,70667,70419,824,576,248
2021-11-01,HO,18,PL01,46816,43208,3608,3608,0
2021-10-12,CA,23,PL02,119736,118536,2448,2448,0
2021-01-07,SD,13,PL17,69105,68943,546,384,162
2021-03-26,SB,11,PL50,12512,12512,5216,5216,0
2021-06-07,CA,23,PL13,84952,84856,216,216,0
2021-11-12,HO,18,PL56,66120,66216,0,0,0
2021-03-26,SD,13,PL25,47652,47669,458,416,42
2021-02-02,SD,13,PL17,73803,72718,1374,208,1166
2021-05-22,HO,18,PL10,54280,54184,96,96,0
2021-05-26,SD,13,PL18,0,0,144,144,0
2021-05-20,DI,19,PL52,208960,205856,3328,3328,0
2021-09-12,HO,18,PL09,72288,72112,176,176,0
2021-03-12,NT,16,PL57,20176,19904,272,272,0
2021-05-21,SB,11,PL50,432352,429216,3776,3776,0
2021-05-22,SD,13,PL18,53265,52881,1120,736,384
2021-04-12,RA,17,PL34,215880,214056,2016,2016,0
2021-02-15,CL,14,PL44,82432,61856,8960,8960,0
2021-10-22,RA,17,PL35,264000,261408,2832,2832,0
2021-01-17,DI,19,PL52,292288,292320,384,384,0
2021-01-29,HO,18,PL30,66152,66152,0,0,0
2021-11-30,RT,21,PL06,208608,208608,0,0,0
2021-03-26,HO,18,PL11,55952,55792,160,160,0
2021-10-20,CH,24,PL07,274195,257892,21807,5504,16303
2021-02-23,CH,24,PL08,76975,75924,22812,21472,1340
2021-06-23,PR,15,PL24,263840,263648,448,448,0
2021-12-07,HO,18,PL09,66160,66184,64,64,0
2021-11-18,RT,21,PL06,165480,164760,696,696,0
2021-02-20,EC,10,PL43,295872,294288,2112,2112,0
2021-12-16,HO,18,PL30,5376,4800,576,576,0
2021-02-19,RA,17,PL34,222960,222648,312,312,0
2021-07-06,PB,25,PL55,447776,447840,960,960,0
2021-06-24,CL,14,PL44,299296,298464,576,576,0
2021-10-17,CL,14,PL44,301504,286240,2304,2304,0
2021-03-24,SD,13,PL21,69251,68702,1106,544,562
2021-06-06,CA,23,PL31,121008,120024,984,984,0
2021-08-22,CA,23,PL31,223416,220104,3312,3312,0
2021-09-08,HO,18,PL30,32,16,400,400,0
2021-01-10,PRG,12,PL14,43744,43072,672,672,0
2021-01-02,DI,19,PL52,212640,211232,1248,1248,0
2021-07-28,HO,18,PL32,61608,61448,488,488,0
2021-09-13,SD,13,PL22,5738,5736,2,0,2
2021-10-29,CH,24,PL07,107554,106644,1870,960,910
2021-08-29,SD,13,PL17,653,0,653,0,653
2021-09-23,CA,23,PL13,84920,84896,112,112,0
2021-05-08,DI,19,PL53,296448,296224,352,352,0
2021-10-23,CL,14,PL45,284640,280192,2912,2912,0
2021-12-18,PR,15,PL24,263008,262912,864,864,0
2021-12-04,DI,19,PL53,294560,294752,832,832,0
2021-05-18,RA,17,PL34,223104,223104,0,0,0
2021-07-17,EC,10,PL43,625200,623712,1296,1296,0
2021-08-24,SD,13,PL21,5108,4692,416,0,416
2021-09-07,PB,25,PL54,448640,449280,3040,3040,0
2021-05-01,HO,18,PL03,66296,66296,0,0,0
2021-06-05,SD,13,PL17,75575,74931,1012,368,644
2021-04-07,NT,16,PL51,469280,468352,1568,1568,0
2021-09-16,PRG,12,PL14,309472,303456,13088,13088,0
2021-10-30,RT,21,PL05,140544,138888,3384,3384,0
2021-12-12,EC,10,PL43,623280,624192,864,864,0
2021-12-12,RA,17,PL56,260880,260352,528,528,0
2021-07-01,HO,18,PL01,28864,27976,1184,1184,0
2021-03-23,SD,13,PL25,57660,57584,1438,1360,78
2021-08-02,HO,18,PL11,65312,65232,120,120,0
2021-10-28,SD,13,PL19,70116,69869,459,176,283
2021-05-09,RT,21,PL06,209976,209256,720,720,0
2021-07-06,HO,18,PL33,65616,65560,88,88,0
2021-01-04,PR,15,PL24,267680,267744,160,160,0
2021-05-01,HO,18,PL01,64832,64128,744,744,0
2021-10-15,HO,18,PL33,132528,132528,0,0,0
2021-01-14,HO,18,PL01,66280,66280,0,0,0
2021-02-06,RA,17,PL34,199704,198528,1536,1536,0
2021-03-28,HO,18,PL30,66224,66224,0,0,0
2021-11-29,PR,15,PL04,262720,262336,704,704,0
2021-01-24,DI,19,PL52,297184,296992,416,416,0
2021-03-23,NT,16,PL57,154928,154736,192,192,0
2021-03-23,PB,25,PL55,447648,446432,1632,1632,0
2021-06-04,PR,15,PL04,70624,69824,1184,1184,0
2021-07-06,HO,18,PL09,73176,73176,0,0,0
2021-04-27,CH,24,PL07,294424,286200,11791,2944,8847
2021-03-06,RA,17,PL35,210816,210456,648,648,0
2021-05-09,DI,19,PL53,294400,293760,768,768,0
2021-11-07,CH,24,PL08,12064,10784,9056,9056,0
2021-08-06,SD,13,PL25,72437,72047,950,464,486
2021-03-07,SB,11,PL36,313584,312888,696,696,0
2021-09-02,HO,18,PL03,62248,62152,96,96,0
2021-09-20,CA,23,PL13,71376,71320,152,152,0
2021-09-08,HO,18,PL40,66264,66264,0,0,0
2021-12-03,SD,13,PL25,60774,59418,1884,528,1356
2021-11-01,HO,18,PL11,66280,66176,104,104,0
2021-05-04,RA,17,PL56,156120,155736,384,384,0
2021-10-29,HO,18,PL01,21736,21344,392,392,0
2021-06-30,RT,21,PL42,119440,104064,15376,15376,0
2021-12-15,SD,13,PL18,62305,61824,4106,3568,538
2021-04-27,RT,21,PL42,127728,121280,8384,8384,0
2021-02-16,RT,21,PL41,26448,25728,720,720,0
2021-11-22,HO,18,PL33,0,0,0,0,0
2021-08-15,RT,21,PL05,201144,200616,1104,1104,0
2021-02-15,DI,19,PL52,295104,295488,544,544,0
2021-11-20,PRG,12,PL14,318560,318528,1056,1056,0
2021-01-14,DI,19,PL53,296096,294656,1632,1632,0
2021-06-09,RT,21,PL42,90176,42480,47696,47696,0
2021-10-27,RA,17,PL34,103584,101400,7704,7704,0
2021-11-24,HO,18,PL01,65272,64312,984,984,0
2021-04-28,CL,14,PL45,1760,0,1760,1760,0
2021-08-27,SD,13,PL22,73095,73056,619,544,75
2021-01-02,CH,24,PL07,0,0,5809,4064,1745
2021-03-13,PW,26,PL37,746784,745680,2592,2592,0
2021-04-19,SD,13,PL17,40896,39356,3192,1648,1544
2021-08-20,PR,15,PL24,198176,195328,2976,2976,0
2021-12-06,SD,13,PL22,62178,62063,691,576,115
2021-09-22,NT,16,PL51,513792,513728,800,800,0
2021-09-17,PB,25,PL55,418816,416096,11616,11616,0
2021-11-11,SD,13,PL20,65314,65135,1793,1600,193
2021-06-28,NT,16,PL51,475840,473760,2720,2720,0
2021-09-25,RT,21,PL05,205872,205728,264,264,0
2021-06-20,EC,10,PL43,623472,621792,1872,1872,0
2021-12-21,HO,18,PL01,68360,68184,184,184,0
2021-03-17,CH,24,PL07,262523,254984,11194,3104,8090
2021-12-12,SD,13,PL18,49474,48953,3231,2704,527
2021-06-19,SD,13,PL18,73105,72466,1809,1152,657
2021-01-30,CH,24,PL08,231464,209294,51578,29408,22170
2021-04-24,PB,25,PL55,447872,448192,896,896,0
2021-09-26,HO,18,PL10,68416,68360,96,96,0
2021-06-21,RT,21,PL42,35520,18864,21712,21712,0
2021-03-30,RA,17,PL34,220872,220752,312,312,0
2021-03-01,HO,18,PL30,16392,14656,1736,1736,0
2021-07-08,PB,25,PL54,246496,227040,20224,20224,0
2021-11-19,EC,10,PL43,531024,530304,2256,2256,0
2021-02-13,DI,19,PL52,261888,261760,128,128,0
2021-10-12,RT,21,PL06,203352,203256,672,672,0
2021-03-25,PB,25,PL55,443552,441312,4576,4576,0
2021-05-19,SD,13,PL19,3271,3265,6,0,6
2021-02-13,PR,15,PL57,143104,142928,176,176,0
2021-10-04,HO,18,PL40,48632,48624,8,8,0
2021-11-25,HO,18,PL10,69352,69328,24,24,0
2021-07-27,RA,17,PL34,184200,184320,576,576,0
2021-07-02,HO,18,PL33,46904,46872,128,128,0
2021-10-03,HO,18,PL01,52352,51536,928,928,0
2021-07-18,CL,14,PL45,292704,288992,2400,2400,0
2021-07-02,SB,11,PL36,185184,184320,888,888,0
2021-06-18,RA,17,PL34,216144,211704,4440,4440,0
2021-09-28,SD,13,PL17,54972,54246,1780,1008,772
2021-10-03,CH,24,PL08,255607,253523,11556,9472,2084
2021-01-27,HO,18,PL32,66624,66592,184,184,0
2021-03-20,RT,21,PL05,185424,184872,552,552,0
2021-07-23,HO,18,PL09,8456,8064,392,392,0
2021-11-19,RT,21,PL41,171856,168464,3504,3504,0
2021-07-09,HO,18,PL40,66280,66232,48,48,0
2021-09-06,RA,17,PL34,219528,217632,2064,2064,0
2021-12-23,CH,24,PL08,68929,68645,405,0,405
2021-10-11,PB,25,PL54,220352,117728,102624,102624,0
2021-08-02,PB,25,PL54,446144,446752,992,992,0
2021-01-26,RT,21,PL41,576,576,0,0,0
2021-01-30,SD,13,PL21,72419,70725,1871,176,1695
2021-03-15,SB,11,PL50,3968,3968,0,0,0
2021-09-14,PR,15,PL04,341632,341216,960,960,0
2021-08-29,RT,21,PL06,125256,124872,792,792,0
2021-01-14,HO,18,PL33,68088,68008,80,80,0
2021-04-24,SB,11,PL36,216168,206736,9528,9528,0
2021-06-04,EC,10,PL43,401664,391680,9648,9648,0
2021-08-23,CA,23,PL31,232008,230808,1344,1344,0
2021-07-03,CL,14,PL44,82496,81888,1696,1696,0
2021-10-20,PB,25,PL55,202080,192384,9760,9760,0
2021-10-13,NT,16,PL51,494016,490080,5600,5600,0
2021-11-02,HO,18,PL32,57648,57648,0,0,0
2021-08-15,CL,14,PL45,294848,287104,3712,3712,0
2021-01-04,HO,18,PL30,64984,64912,120,120,0
2021-04-13,CL,14,PL45,292384,276832,8352,8352,0
2021-01-29,CA,23,PL13,85040,85128,256,256,0
2021-04-04,HO,18,PL33,65392,65184,208,208,0
2021-05-20,CA,23,PL13,85272,85240,144,144,0
2021-11-20,RA,17,PL34,18504,17832,672,672,0
2021-04-25,RT,21,PL06,202872,202968,456,456,0
2021-06-29,RT,21,PL42,183312,177472,5968,5968,0
2021-06-27,HO,18,PL32,67624,67504,128,128,0
2021-01-23,HO,18,PL11,66104,65976,168,168,0
2021-11-30,CH,24,PL24,164000,164240,176,176,0
2021-09-26,DI,19,PL53,295136,295648,352,352,0
2021-11-27,HO,18,PL33,71880,71928,88,88,0
2021-12-03,CH,24,PL07,254552,242533,21565,8864,12701
2021-10-17,PRG,12,PL14,390560,390656,1184,1184,0
2021-06-05,HO,18,PL10,56792,56704,88,88,0
2021-10-22,PR,15,PL04,41344,31456,10208,10208,0
2021-09-28,HO,18,PL01,66384,66128,280,280,0
2021-10-07,CH,24,PL07,290329,280778,20417,10688,9729
2021-08-20,PR,15,PL04,251456,248544,2912,2912,0
2021-11-14,RT,21,PL06,206328,206208,336,336,0
2021-08-29,SD,13,PL20,76155,76112,331,272,59
2021-02-18,RT,21,PL06,183552,182568,2808,2808,0
2021-08-03,PR,15,PL24,264576,263936,1536,1536,0
2021-06-07,CA,23,PL11,233568,232440,1656,1656,0
2021-06-26,PRG,12,PL14,393056,392864,800,800,0
2021-04-20,SD,13,PL25,56901,55414,7583,6096,1487
2021-05-01,HO,18,PL10,40832,40176,656,656,0
2021-10-10,CL,14,PL44,293280,268192,2784,2784,0
2021-03-07,RA,17,PL35,219672,219168,672,672,0
2021-06-14,HO,18,PL10,56368,55344,1024,1024,0
2021-11-03,PB,25,PL54,175904,167808,18048,18048,0
2021-05-19,SD,13,PL21,60920,60393,1070,480,590
2021-05-18,RT,21,PL42,132160,131936,368,368,0
2021-08-13,HO,18,PL03,67016,67064,88,88,0
2021-01-10,RA,17,PL35,198240,193752,4824,4824,0
2021-09-07,SD,13,PL22,72288,72176,754,656,98
2021-09-12,CA,23,PL02,226200,225648,744,744,0
2021-09-18,SD,13,PL18,75482,75255,726,384,342
2021-09-24,HO,18,PL03,67616,67616,0,0,0
2021-06-27,DI,19,PL53,295168,293952,1632,1632,0
2021-12-22,SB,11,PL36,42936,42864,72,72,0
2021-09-23,SD,13,PL21,66161,65815,698,352,346
2021-04-01,HO,18,PL09,71600,71504,96,96,0
2021-04-23,SD,13,PL18,73611,73233,758,368,390
2021-01-10,CH,24,PL57,34248,34228,48,48,0
2021-11-01,RT,21,PL41,5664,1168,19776,19776,0
2021-01-19,RA,17,PL34,185880,183912,2064,2064,0
2021-03-14,HO,18,PL11,64704,64488,216,216,0
2021-12-04,SB,11,PL36,138744,138120,1056,1056,0
2021-04-07,SD,13,PL18,70375,69494,1793,912,881
2021-01-18,HO,18,PL33,67976,67904,88,88,0
2021-05-17,RA,17,PL56,217104,212928,4176,4176,0
2021-05-18,EC,10,PL43,168288,163440,10224,10224,0
2021-05-18,DI,19,PL53,298112,295744,2560,2560,0
2021-05-30,HO,18,PL32,67272,67048,224,224,0
2021-01-06,SD,13,PL25,57386,56958,1915,1472,443
2021-02-06,EC,10,PL43,617616,615264,2592,2592,0
2021-09-08,RA,17,PL34,93120,92376,2256,2256,0
2021-01-24,HO,18,PL09,71992,71928,104,104,0
2021-06-11,SD,13,PL18,75423,74981,1242,800,442
2021-04-10,CH,24,PL12,131280,130976,448,448,0
2021-12-22,HO,18,PL10,0,0,3840,3840,0
2021-07-15,CL,14,PL45,263264,257696,4800,4800,0
2021-10-08,PRG,12,PL14,391520,390848,1184,1184,0
2021-09-12,DI,19,PL52,291648,290848,1248,1248,0
2021-09-20,HO,18,PL40,63640,63528,336,336,0
2021-07-16,HO,18,PL32,67832,67808,104,104,0
2021-07-04,NT,16,PL51,395808,394432,1376,1376,0
2021-08-25,CA,23,PL02,231840,231576,720,720,0
2021-07-13,EC,10,PL43,616128,611424,4320,4320,0
2021-08-09,CL,14,PL44,295232,291712,2880,2880,0
2021-03-08,CA,23,PL02,234528,232176,2472,2472,0
2021-02-11,SD,13,PL18,69452,68649,1220,416,804
2021-06-24,SD,13,PL19,76397,76348,225,176,49
2021-06-24,CL,14,PL45,288416,285728,2400,2400,0
2021-01-17,SD,13,PL19,55807,54848,1405,352,1053
2021-02-16,RT,21,PL05,205392,203976,1560,1560,0
2021-05-27,CH,24,PL08,273125,268932,17274,12928,4346
2021-10-08,PR,15,PL04,261664,254688,7328,7328,0
2021-02-26,CL,14,PL44,299392,287872,3904,3904,0
2021-04-11,PW,26,PL37,704688,696144,8880,8880,0
2021-05-22,NT,16,PL51,435168,434336,1024,1024,0
2021-04-06,HO,18,PL10,56320,56224,216,216,0
2021-05-21,CH,24,PL57,25820,18488,7332,7332,0
2021-12-22,CH,24,PL08,154987,153900,11172,7296,3876
2021-07-07,HO,18,PL30,66224,66224,0,0,0
2021-08-30,HO,18,PL03,68288,68264,80,80,0
2021-10-15,HO,18,PL30,0,0,1040,1040,0
2021-01-05,PR,15,PL04,259200,258688,896,896,0
2021-03-25,RA,17,PL35,0,0,6792,6792,0
2021-05-10,CH,24,PL07,240179,227754,17483,5056,12427
2021-03-18,CL,14,PL45,72000,24896,21568,21568,0
2021-08-05,HO,18,PL01,36144,35624,520,520,0
2021-11-26,SD,13,PL21,66146,65823,331,0,331
2021-11-18,SB,11,PL36,81144,80592,6864,6864,0
2021-08-12,CL,14,PL45,291616,285152,4352,4352,0
2021-12-15,RT,21,PL05,207840,207216,768,768,0
2021-08-22,RT,21,PL05,205824,205944,288,288,0
2021-10-16,SB,11,PL50,452256,451040,1856,1856,0
2021-01-13,HO,18,PL11,62656,61104,1552,1552,0
2021-08-19,HO,18,PL09,61232,60896,536,536,0
2021-10-28,SD,13,PL21,30186,30080,783,560,223
2021-12-10,DI,19,PL53,152384,151520,1248,1248,0
2021-09-09,HO,18,PL33,130640,130576,208,208,0
2021-08-09,PRG,12,PL14,388288,387232,2752,2752,0
2021-02-09,PR,15,PL24,248064,246784,1664,1664,0
2021-08-22,PR,15,PL04,214496,214560,416,416,0
2021-08-09,HO,18,PL56,66176,66048,128,128,0
2021-10-31,HO,18,PL01,54416,53632,784,784,0
2021-02-21,HO,18,PL03,66224,66224,0,0,0
2021-06-26,CA,23,PL02,230040,228456,1872,1872,0
2021-11-07,SD,13,PL19,76280,75473,1056,176,880
2021-05-07,DI,19,PL52,293856,292736,1280,1280,0
2021-05-19,PB,25,PL55,442944,432032,11744,11744,0
2021-07-24,HO,18,PL10,0,0,0,0,0
2021-04-27,HO,18,PL01,62864,62680,216,216,0
2021-01-26,DI,19,PL53,25056,24928,3168,3168,0
2021-07-17,SD,13,PL18,70245,69292,1414,384,1030
2021-08-17,CA,23,PL02,0,0,936,936,0
2021-12-21,CA,23,PL35,78520,78408,232,232,0
2021-10-30,RT,21,PL06,79824,76704,3696,3696,0
2021-02-06,CA,23,PL13,76456,76560,264,264,0
2021-05-27,NT,16,PL51,467136,467200,736,736,0
2021-11-10,PR,15,PL04,268128,267808,320,320,0
2021-01-21,SD,13,PL22,67630,66879,1231,480,751
2021-07-22,CH,24,PL08,312302,311262,3737,2560,1177
2021-08-12,RT,21,PL41,41136,34464,6672,6672,0
2021-07-18,PB,25,PL55,448224,448448,2112,2112,0
2021-03-23,SD,13,PL22,75920,75757,867,704,163
2021-04-16,RA,17,PL34,167256,164784,3360,3360,0
2021-06-29,DI,19,PL52,272704,271232,1600,1600,0
2021-01-10,SB,11,PL36,308952,307536,2040,2040,0
2021-06-17,NT,16,PL51,462048,454944,7968,7968,0
2021-11-15,SB,11,PL50,454368,453152,1216,1216,0
2021-01-10,HO,18,PL33,67704,67712,88,88,0
2021-10-22,CL,14,PL44,145600,141088,4448,4448,0
2021-04-13,SD,13,PL20,75952,75816,394,176,218
2021-10-04,SD,13,PL19,75963,75777,640,368,272
2021-11-24,CA,23,PL13,84048,83776,312,312,0
2021-12-22,PB,25,PL54,433152,431424,1728,1728,0
2021-04-15,HO,18,PL30,65416,65344,136,136,0
2021-08-16,SD,13,PL20,71921,71895,426,400,26
2021-05-04,PR,15,PL57,140976,140912,192,192,0
2021-01-26,CL,14,PL44,306368,302208,768,768,0
2021-05-31,CA,23,PL11,223032,220080,10488,10488,0
2021-08-30,CA,23,PL02,93552,93216,504,504,0
2021-01-07,HO,18,PL03,64848,64752,192,192,0
2021-04-10,HO,18,PL32,67976,67720,256,256,0
2021-08-02,SD,13,PL20,76299,76256,235,192,43
2021-02-08,HO,18,PL33,25360,25168,192,192,0
2021-01-31,SD,13,PL19,64448,62737,1904,176,1728
2021-10-06,HO,18,PL32,56792,56648,144,144,0
2021-06-07,SB,11,PL36,301056,291240,10032,10032,0
2021-09-23,PRG,12,PL14,382336,381472,1760,1760,0
2021-03-02,PRG,12,PL14,396832,396320,896,896,0
2021-02-25,RA,17,PL34,221880,221256,624,624,0
2021-12-22,RT,21,PL05,206472,204792,1920,1920,0
2021-06-13,DI,19,PL52,290656,288224,2720,2720,0
2021-09-27,HO,18,PL33,131552,131168,384,384,0
2021-03-05,SD,13,PL22,71916,71803,606,448,158
2021-06-12,SD,13,PL17,69990,68943,1671,624,1047
2021-01-25,HO,18,PL03,66632,65808,824,824,0
2021-03-01,CH,24,PL07,259369,243703,42319,26208,16111
2021-03-28,HO,18,PL11,64704,64632,168,168,0
2021-02-01,NT,16,PL51,232320,229248,4160,4160,0
2021-05-08,HO,18,PL10,56688,56664,152,152,0
2021-04-10,SB,11,PL50,449312,447680,3296,3296,0
2021-11-25,RA,17,PL56,24408,18576,9048,9048,0
2021-12-09,PB,25,PL55,449504,446656,3328,3328,0
2021-01-16,HO,18,PL09,67184,66680,560,560,0
2021-05-28,HO,18,PL33,131072,129392,1680,1680,0
2021-06-04,SD,13,PL17,33854,33345,4956,3952,1004
2021-10-22,HO,18,PL11,66288,66288,0,0,0
2021-08-16,RA,17,PL34,222456,222192,264,264,0
2021-12-22,RA,17,PL56,210984,210336,2352,2352,0
2021-01-16,CH,24,PL57,34092,34116,52,52,0
2021-11-17,PB,25,PL54,427104,411360,18304,18304,0
2021-10-16,SD,13,PL19,75302,75061,609,368,241
2021-01-24,HO,18,PL03,66896,66528,368,368,0
2021-04-09,PR,15,PL57,138928,138656,352,352,0
2021-07-14,CL,14,PL45,282080,276032,5472,5472,0
2021-04-08,NT,16,PL51,467936,466464,2240,2240,0
2021-11-30,PRG,12,PL14,371808,364800,7488,7488,0
2021-01-18,SB,11,PL50,444320,439008,6176,6176,0
2021-11-03,RT,21,PL41,90624,79872,11232,11232,0
2021-05-08,CL,14,PL45,297248,287456,3296,3296,0
2021-10-02,PB,25,PL54,440096,427008,13408,13408,0
2021-10-23,RA,17,PL34,258744,256872,1968,1968,0
2021-05-11,CA,23,PL02,111096,110232,1656,1656,0
2021-10-27,PRG,12,PL14,391392,389952,1440,1440,0
2021-03-24,HO,18,PL03,47976,45848,2128,2128,0
2021-03-23,DI,19,PL53,298400,298048,736,736,0
2021-11-18,RT,21,PL05,38808,35112,3696,3696,0
2021-04-26,PR,15,PL04,257728,257216,1792,1792,0
2021-04-29,PR,15,PL04,262848,262528,640,640,0
2021-02-03,RT,21,PL41,4000,3472,528,528,0
2021-06-08,RA,17,PL56,220512,219912,600,600,0
2021-05-19,RA,17,PL35,226656,226296,696,696,0
2021-07-20,HO,18,PL32,65864,65728,136,136,0
2021-11-25,SD,13,PL25,72403,71787,1352,736,616
2021-01-16,NT,16,PL51,466624,464192,2624,2624,0
2021-03-05,NT,16,PL57,129712,127632,2080,2080,0
2021-03-21,SD,13,PL21,72700,72112,1025,400,625
2021-10-25,PB,25,PL54,77728,74528,34112,34112,0
2021-12-13,CA,23,PL31,236160,235296,1272,1272,0
2021-11-03,CA,23,PL02,230688,230808,384,384,0
2021-06-20,RA,17,PL35,167856,163872,4320,4320,0
2021-10-17,RA,17,PL34,183576,168768,14856,14856,0
2021-12-03,DI,19,PL53,223904,222656,1536,1536,0
2021-04-01,HO,18,PL01,65952,65776,224,224,0
2021-06-20,HO,18,PL30,66224,66224,0,0,0
2021-06-19,RA,17,PL35,217056,211824,5232,5232,0
2021-11-03,CH,24,PL07,287322,284437,10010,6688,3322
2021-09-04,CA,23,PL13,85576,85512,96,96,0
2021-08-25,SD,13,PL17,74897,74597,540,240,300
2021-01-21,DI,19,PL52,295712,294784,1024,1024,0
2021-04-23,HO,18,PL33,55192,55376,0,0,0
2021-01-08,RA,17,PL35,209280,203616,5664,5664,0
2021-04-10,HO,18,PL03,66248,66248,0,0,0
2021-09-08,PR,15,PL04,148352,146752,2048,2048,0
2021-02-17,HO,18,PL33,67552,66880,752,752,0
2021-05-28,SD,13,PL18,3821,2715,5650,4544,1106
2021-06-10,SD,13,PL21,75715,75162,761,192,569
2021-04-11,HO,18,PL03,66240,66104,136,136,0
2021-05-20,CH,24,PL12,124544,123808,736,736,0
2021-05-28,SD,13,PL22,60920,60361,911,352,559
2021-06-23,PB,25,PL55,191712,188544,8704,8704,0
2021-08-16,SD,13,PL17,71406,71231,372,208,164
2021-11-11,HO,18,PL11,66256,66256,0,0,0
2021-03-01,SD,13,PL21,70408,69906,918,416,502
2021-06-01,CH,24,PL08,29883,28705,1658,480,1178
2021-10-26,SD,13,PL17,24976,24806,170,0,170
2021-12-07,SD,13,PL18,44434,43924,991,208,783
2021-03-11,RT,21,PL41,19792,1392,27680,27680,0
2021-09-14,SD,13,PL18,76069,75770,739,384,355
2021-10-13,CA,23,PL02,232200,232008,312,312,0
2021-09-05,HO,18,PL56,64568,64048,520,520,0
2021-01-13,HO,18,PL03,67016,66208,856,856,0
2021-05-18,HO,18,PL10,57640,57680,0,0,0
2021-12-01,HO,18,PL33,55160,55056,200,200,0
2021-07-19,HO,18,PL09,70512,69888,688,688,0
2021-06-29,HO,18,PL09,71224,70840,384,384,0
2021-08-16,RA,17,PL35,142248,140904,1344,1344,0
2021-03-02,NT,16,PL51,411936,409408,3008,3008,0
2021-05-06,RA,17,PL56,220608,220320,288,288,0
2021-08-19,CH,24,PL08,195651,182185,22477,8128,14349
2021-09-21,HO,18,PL11,65048,64824,288,288,0
2021-11-25,NT,16,PL51,510816,510912,736,736,0
2021-02-24,CH,24,PL08,211219,207360,20979,17120,3859
2021-05-22,RA,17,PL56,198600,198024,576,576,0
2021-09-30,CH,24,PL12,155312,154944,912,912,0
2021-03-13,HO,18,PL01,66224,66128,96,96,0
2021-01-04,SB,11,PL36,286728,284280,2472,2472,0
2021-01-06,CH,24,PL57,34184,34168,48,48,0
2021-06-16,PR,15,PL12,139648,139776,176,176,0
2021-09-19,RA,17,PL35,217872,214248,4992,4992,0
2021-06-21,HO,18,PL03,66384,66160,224,224,0
2021-06-03,HO,18,PL09,72096,72008,88,88,0
2021-03-18,NT,16,PL51,467392,465536,2496,2496,0
2021-02-17,RT,21,PL42,177632,173920,4480,4480,0
2021-06-08,CH,24,PL57,12640,12624,20,20,0
2021-08-01,RT,21,PL42,189696,187056,2848,2848,0
2021-06-06,HO,18,PL10,57720,57720,0,0,0
2021-03-09,SB,11,PL36,308880,308400,1488,1488,0
2021-04-25,PR,15,PL24,261952,261024,1504,1504,0
2021-12-06,PR,15,PL04,262080,261536,704,704,0
2021-03-05,HO,18,PL01,64872,63912,992,992,0
2021-05-29,DI,19,PL53,298272,298528,352,352,0
2021-08-18,CH,24,PL08,0,0,0,0,0
2021-06-22,SD,13,PL19,72717,72674,2234,2176,58
2021-09-04,HO,18,PL11,66264,66264,0,0,0
2021-02-26,RT,21,PL42,189616,183872,5872,5872,0
2021-12-12,SD,13,PL19,65028,63983,1397,352,1045
2021-08-17,SB,11,PL50,142464,140608,2016,2016,0
2021-11-23,SD,13,PL19,63648,63543,314,192,122
2021-06-30,SD,13,PL18,66786,65716,1096,0,1096
2021-09-12,SD,13,PL19,76430,76394,228,192,36
2021-06-08,CH,24,PL08,125981,109996,43207,22656,20551
2021-05-20,DI,19,PL53,224288,223040,1536,1536,0
2021-10-06,CL,14,PL45,289408,284768,3616,3616,0
2021-03-13,SD,13,PL25,72064,71992,649,544,105
2021-11-26,SB,11,PL50,384576,375296,9984,9984,0
2021-03-02,RT,21,PL42,125600,111936,14112,14112,0
2021-08-19,RT,21,PL06,0,0,0,0,0
2021-02-06,SD,13,PL20,74586,73244,2288,944,1344
2021-03-11,HO,18,PL10,56136,55856,488,488,0
2021-04-16,HO,18,PL32,67376,67144,232,232,0
2021-08-29,SD,13,PL22,42161,42111,565,512,53
2021-09-06,HO,18,PL11,54408,54064,344,344,0
2021-05-16,CL,14,PL45,271744,267680,4000,4000,0
2021-03-04,RT,21,PL41,4720,4816,2256,2256,0
2021-10-02,EC,10,PL43,615168,613392,1584,1584,0
2021-12-10,SD,13,PL21,64477,64404,454,368,86
2021-10-10,SB,11,PL36,312600,310224,2448,2448,0
2021-01-06,HO,18,PL32,64016,63936,272,272,0
2021-03-06,EC,10,PL43,630576,629856,528,528,0
2021-08-05,PB,25,PL54,384352,383264,1088,1088,0
2021-10-13,PW,26,PL37,814512,809040,5712,5712,0
2021-11-25,PW,26,PL37,812256,813360,2256,2256,0
2021-02-21,DI,19,PL52,265600,265120,576,576,0
2021-12-15,PW,26,PL37,811536,812400,3456,3456,0
2021-06-01,HO,18,PL40,66048,65704,344,344,0
2021-08-09,CH,24,PL57,32584,32468,148,148,0
2021-12-13,HO,18,PL10,69384,69384,0,0,0
2021-05-01,CA,23,PL13,84800,84880,96,96,0
2021-09-01,HO,18,PL33,43592,43280,504,504,0
2021-11-25,SD,13,PL17,74709,74535,350,176,174
2021-01-13,DI,19,PL53,256448,253632,3136,3136,0
2021-08-04,CH,24,PL07,306903,302198,10436,5632,4804
2021-09-13,HO,18,PL03,66488,66304,256,256,0
2021-04-08,CA,23,PL31,227112,224280,3144,3144,0
2021-06-08,HO,18,PL03,24,0,24,24,0
2021-01-28,NT,16,PL51,467296,466912,1088,1088,0
2021-09-22,SB,11,PL36,22896,22872,24,24,0
2021-06-15,RT,21,PL06,104880,104664,8448,8448,0
2021-03-16,RA,17,PL34,184920,184608,912,912,0
2021-03-20,SD,13,PL25,61498,61436,2078,2016,62
2021-12-18,HO,18,PL32,56032,55824,272,272,0
2021-01-24,DI,19,PL53,296800,296640,352,352,0
2021-01-22,HO,18,PL30,64136,63968,280,280,0
2021-06-13,PW,26,PL37,815760,815520,2256,2256,0
2021-10-30,HO,18,PL33,119424,117840,1584,1584,0
2021-05-06,SD,13,PL17,73533,73181,916,576,340
2021-11-02,RT,21,PL05,125424,118560,6864,6864,0
2021-12-11,HO,18,PL32,56696,56632,96,96,0
2021-10-16,PB,25,PL55,433024,402752,40608,40608,0
2021-06-16,HO,18,PL30,66104,65368,736,736,0
2021-08-29,PR,15,PL04,354336,353216,1792,1792,0
2021-01-13,SD,13,PL25,64757,64422,1443,1104,339
2021-06-21,SB,11,PL36,304152,297024,7344,7344,0
2021-02-10,RA,17,PL35,158976,158376,1488,1488,0
2021-09-13,CH,24,PL08,313517,311626,4854,2752,2102
2021-01-18,HO,18,PL11,1520,1512,80,80,0
2021-04-09,CA,23,PL13,85376,85216,288,288,0
2021-07-26,HO,18,PL32,67464,67384,136,136,0
2021-06-23,DI,19,PL52,266880,266848,1408,1408,0
2021-05-23,RT,21,PL42,184752,177568,7952,7952,0
2021-07-09,PRG,12,PL14,236672,228640,8928,8928,0
2021-01-09,SD,13,PL20,73362,72377,1787,736,1051
2021-02-08,CH,24,PL08,211315,207869,9846,6400,3446
2021-06-05,PR,15,PL12,138992,138816,176,176,0
2021-10-10,HO,18,PL32,56296,56120,176,176,0
2021-02-20,PRG,12,PL12,395648,394720,928,928,0
2021-06-28,SD,13,PL18,74515,73975,1564,1024,540
2021-08-25,SD,13,PL20,75344,75240,853,736,117
2021-11-25,HO,18,PL01,64752,64016,736,736,0
2021-09-13,HO,18,PL11,66240,66304,0,0,0
2021-07-02,SB,11,PL50,450720,448928,2272,2272,0
2021-07-23,PW,26,PL37,800784,796464,5280,5280,0
2021-07-23,HO,18,PL56,66112,65992,120,120,0
2021-01-30,CL,14,PL44,308512,301120,1568,1568,0
2021-06-22,HO,18,PL09,68232,68208,152,152,0
2021-10-21,SB,11,PL50,452480,451392,1792,1792,0
2021-10-23,PW,26,PL37,810048,810672,1488,1488,0
2021-03-12,HO,18,PL10,56600,56504,96,96,0
2021-10-05,SD,13,PL25,74324,73812,1165,576,589
2021-10-10,SD,13,PL19,75168,75026,387,208,179
2021-11-28,CA,23,PL02,196056,195456,984,984,0
2021-05-07,PW,26,PL37,468192,466512,7248,7248,0
2021-01-09,CL,14,PL44,139936,138464,128,128,0
2021-08-08,HO,18,PL56,65976,65520,456,456,0
2021-11-16,PB,25,PL54,428640,409216,20160,20160,0
2021-02-17,NT,16,PL51,467776,464992,3424,3424,0
2021-05-08,CH,24,PL07,321825,292673,31936,2784,29152
2021-02-18,HO,18,PL10,27680,26568,1112,1112,0
2021-08-21,SD,13,PL18,75901,75336,917,352,565
2021-10-04,SD,13,PL20,72109,71575,1350,816,534
2021-01-07,SD,13,PL20,72956,72602,1379,944,435
2021-01-25,HO,18,PL11,61368,60256,1112,1112,0
2021-09-19,HO,18,PL40,66200,66272,0,0,0
2021-07-24,HO,18,PL09,27248,27040,208,208,0
2021-10-04,CH,24,PL08,299031,291359,18884,11136,7748
2021-11-10,PW,26,PL37,732624,726912,8208,8208,0
2021-05-23,CA,23,PL31,224472,222144,2400,2400,0
2021-10-22,RT,21,PL05,207408,205368,2400,2400,0
2021-11-07,HO,18,PL32,56040,55984,184,184,0
2021-03-25,RT,21,PL06,204384,201720,2712,2712,0
2021-12-17,PR,15,PL24,250464,248832,1632,1632,0
2021-04-05,CH,24,PL08,251473,248585,7462,4288,3174
2021-07-24,EC,10,PL43,29328,29328,1728,1728,0
2021-02-09,HO,18,PL11,51896,51848,48,48,0
2021-07-14,SD,13,PL17,70743,69640,1608,448,1160
2021-11-26,SB,11,PL36,249552,244752,5136,5136,0
2021-02-12,HO,18,PL03,66120,66144,0,0,0
2021-11-04,HO,18,PL01,68232,68224,32,32,0
2021-04-14,CH,24,PL12,160720,159920,944,944,0
2021-05-16,RA,17,PL34,168600,163776,4824,4824,0
2021-06-23,HO,18,PL03,66344,66392,144,144,0
2021-07-15,PRG,12,PL14,238464,236224,2240,2240,0
2021-04-27,PB,25,PL55,84896,70080,15648,15648,0
2021-12-01,PRG,12,PL54,259712,251104,8960,8960,0
2021-12-01,PRG,12,PL14,373760,370144,3840,3840,0
2021-03-06,DI,19,PL53,255424,255296,128,128,0
2021-05-04,RT,21,PL42,82704,58720,23984,23984,0
2021-11-20,SD,13,PL18,75251,74907,976,608,368
2021-11-05,DI,19,PL52,289696,286944,3680,3680,0
2021-06-28,SB,11,PL50,386496,385120,9184,9184,0
2021-11-02,RA,17,PL35,121248,115032,8712,8712,0
2021-05-10,RT,21,PL05,184416,183528,2160,2160,0
2021-06-22,CH,24,PL08,43286,40712,4116,1088,3028
2021-01-17,SB,11,PL36,303216,298872,6048,6048,0
2021-05-25,CA,23,PL02,176712,175680,1944,1944,0
2021-04-07,RA,17,PL35,225168,224352,816,816,0
2021-12-02,CH,24,PL08,263170,259030,8300,4160,4140
2021-12-03,HO,18,PL03,62240,62136,296,296,0
2021-06-30,HO,18,PL10,57720,57720,0,0,0
2021-09-18,SD,13,PL25,74471,72800,1847,176,1671
2021-04-07,CA,23,PL31,196176,187128,9672,9672,0
2021-06-02,SD,13,PL22,68103,67639,1100,544,556
2021-10-01,PR,15,PL24,267264,266528,960,960,0
2021-07-24,PW,26,PL37,482352,482160,13344,13344,0
2021-10-19,RT,21,PL42,11712,3120,8592,8592,0
2021-05-18,CA,23,PL11,236280,234120,2712,2712,0
2021-12-17,HO,18,PL09,45136,44648,624,624,0
2021-02-24,SB,11,PL36,312864,312144,1224,1224,0
2021-03-29,RT,21,PL42,179984,178144,2064,2064,0
2021-08-01,SD,13,PL17,72634,71627,1211,192,1019
2021-07-03,CH,24,PL07,200999,193190,18988,4928,14060
2021-11-20,SB,11,PL50,457984,457408,1344,1344,0
2021-10-10,PR,15,PL04,257344,249184,8448,8448,0
2021-01-21,SB,11,PL36,225072,222432,10488,10488,0
2021-02-08,PR,15,PL57,142784,142608,176,176,0
2021-03-14,SD,13,PL25,39711,38003,1708,0,1708
2021-10-27,CH,24,PL07,76709,75279,15907,3136,12771
2021-04-13,PRG,12,PL14,392192,391840,1024,1024,0
2021-11-16,SB,11,PL50,403872,401920,3392,3392,0
2021-06-25,CL,14,PL44,298944,298336,480,480,0
2021-12-03,HO,18,PL09,62880,60096,2832,2832,0
2021-05-05,HO,18,PL10,24120,24032,1416,1416,0
2021-12-14,CA,23,PL31,180168,179688,1608,1608,0
2021-02-02,DI,19,PL53,96448,95744,1024,1024,0
2021-11-18,CH,24,PL57,33076,33004,140,140,0
2021-09-25,DI,19,PL52,283200,282080,1280,1280,0
2021-01-27,HO,18,PL09,67648,67400,400,400,0
2021-07-10,CL,14,PL45,293568,290208,2976,2976,0
2021-11-27,SD,13,PL17,13135,11954,5085,3904,1181
2021-11-15,CH,24,PL57,34172,34128,44,44,0
2021-01-12,PB,25,PL55,441376,437024,5184,5184,0
2021-08-16,CA,23,PL02,0,0,480,480,0
2021-08-07,PB,25,PL54,162560,159008,3552,3552,0
2021-02-10,RT,21,PL05,209664,209832,0,0,0
2021-03-26,CH,24,PL07,242694,229933,17626,3872,13754
2021-05-26,RA,17,PL35,173616,171744,1944,1944,0
2021-10-12,CH,24,PL07,61192,60762,4428,2912,1516
2021-01-04,HO,18,PL09,66288,66264,24,24,0
2021-03-16,CH,24,PL07,286465,281907,8924,4256,4668
2021-10-27,HO,18,PL32,56616,56536,88,88,0
2021-01-21,PRG,12,PL14,0,0,48736,48736,0
2021-10-05,HO,18,PL56,45264,42320,2944,2944,0
2021-11-26,PRG,12,PL14,391104,390144,960,960,0
2021-02-16,CH,24,PL04,155232,155280,208,208,0
2021-05-30,HO,18,PL30,66224,66224,0,0,0
2021-04-30,DI,19,PL52,223040,218592,4448,4448,0
2021-05-07,HO,18,PL10,37056,36848,208,208,0
2021-10-20,HO,18,PL11,65280,65256,104,104,0
2021-06-14,HO,18,PL33,128544,128416,288,288,0
2021-12-06,HO,18,PL33,68320,68080,224,224,0
2021-01-09,PRG,12,PL14,395712,393600,2336,2336,0
2021-02-18,CA,23,PL31,30504,27240,3264,3264,0
2021-04-26,PW,26,PL37,775968,771024,7056,7056,0
2021-12-04,PR,15,PL04,264480,264192,448,448,0
2021-03-24,RA,17,PL34,221808,221064,912,912,0
2021-12-09,SD,13,PL20,53273,52878,779,384,395
2021-07-23,CL,14,PL44,299008,294880,3168,3168,0
2021-11-30,CH,24,PL07,285234,280305,8325,3200,5125
2021-03-07,CA,23,PL13,85344,85232,168,168,0
2021-07-05,PR,15,PL04,16384,16352,32,32,0
2021-05-09,CA,23,PL13,80512,80408,304,304,0
2021-10-08,HO,18,PL33,128688,128464,224,224,0
2021-11-02,RT,21,PL06,202392,185856,16536,16536,0
2021-04-25,PB,25,PL54,413312,401600,12384,12384,0
2021-10-15,DI,19,PL52,258912,258432,896,896,0
2021-02-11,HO,18,PL30,64768,64840,176,176,0
2021-06-16,HO,18,PL09,69368,68680,688,688,0
2021-05-28,HO,18,PL01,65824,65536,568,568,0
2021-06-16,RT,21,PL06,199512,198120,1416,1416,0
2021-10-29,SB,11,PL50,101952,101536,416,416,0
2021-01-26,SB,11,PL36,284448,272112,14616,14616,0
2021-07-06,CH,24,PL57,21420,21324,96,96,0
2021-10-07,SB,11,PL50,219520,213856,5824,5824,0
2021-11-24,PB,25,PL55,448032,443520,6720,6720,0
2021-11-04,PB,25,PL54,64160,56160,26656,26656,0
2021-04-16,HO,18,PL01,66208,66112,96,96,0
2021-11-15,PRG,12,PL12,380576,379040,5248,5248,0
2021-06-07,HO,18,PL40,64296,63352,944,944,0
2021-10-16,PRG,12,PL14,391424,390752,1088,1088,0
2021-01-28,SB,11,PL50,440352,436864,3776,3776,0
2021-02-08,SD,13,PL25,73262,72018,1452,208,1244
2021-10-13,SD,13,PL22,5571,4899,16352,15680,672
2021-04-24,NT,16,PL51,448640,445344,4192,4192,0
2021-10-19,HO,18,PL11,66232,66088,144,144,0
2021-09-11,HO,18,PL10,68488,68480,120,120,0
2021-09-18,CA,23,PL31,235536,235104,888,888,0
2021-03-07,NT,16,PL57,152784,152512,352,352,0
2021-09-26,SD,13,PL17,74560,74414,819,656,163
2021-07-01,RT,21,PL05,206232,205968,552,552,0
2021-03-07,RA,17,PL34,220680,220200,552,552,0
2021-06-17,CA,23,PL11,237672,237336,840,840,0
2021-08-27,HO,18,PL09,71816,71768,120,120,0
2021-01-02,SD,13,PL21,41288,40410,1084,0,1084
2021-09-07,CL,14,PL45,182560,171424,9184,9184,0
2021-02-07,HO,18,PL10,56640,56632,120,120,0
2021-06-21,CL,14,PL44,185920,185280,384,384,0
2021-08-02,HO,18,PL56,63288,62888,400,400,0
2021-01-09,SD,13,PL22,70646,70070,851,192,659
2021-06-07,CA,23,PL02,174264,171528,4320,4320,0
2021-09-13,SB,11,PL36,306888,305688,1536,1536,0
2021-07-31,SD,13,PL20,68853,68511,1086,720,366
2021-09-29,SD,13,PL18,76291,75882,601,192,409
2021-10-29,PB,25,PL54,153600,153792,224,224,0
2021-04-23,CH,24,PL07,157897,153657,7184,2944,4240
2021-04-14,HO,18,PL03,66240,66240,0,0,0
2021-02-10,SD,13,PL22,61598,61448,678,528,150
2021-04-03,CH,24,PL08,200460,196488,9796,5824,3972
2021-06-25,HO,18,PL03,60792,59816,1088,1088,0
2021-11-15,EC,10,PL43,449664,444528,5376,5376,0
2021-01-08,CL,14,PL44,304864,302016,1088,1088,0
2021-09-11,SD,13,PL17,76161,76119,157,16,141
2021-01-31,DI,19,PL52,294816,295104,352,352,0
2021-09-16,CL,14,PL45,288320,281088,5792,5792,0
2021-01-09,CA,23,PL02,227208,222768,4584,4584,0
2021-06-09,RT,21,PL05,179112,178992,144,144,0
2021-06-10,CA,23,PL02,210720,209376,1416,1416,0
2021-09-14,SD,13,PL17,62259,62028,2688,2384,304
2021-04-25,HO,18,PL30,65904,65648,256,256,0
2021-11-03,HO,18,PL01,63640,62728,1112,1112,0
2021-11-03,NT,16,PL51,0,0,3200,3200,0
2021-10-09,PB,25,PL54,406144,387872,19552,19552,0
2021-06-11,PR,15,PL04,167104,163072,5952,5952,0
2021-11-19,CA,23,PL31,231816,229248,2832,2832,0
2021-12-22,HO,18,PL09,57360,57248,112,112,0
2021-08-09,HO,18,PL33,65584,65496,88,88,0
2021-01-31,HO,18,PL09,72200,72096,104,104,0
2021-04-10,SD,13,PL20,74657,73167,1844,368,1476
2021-10-03,CL,14,PL45,292704,288864,2880,2880,0
2021-03-11,DI,19,PL52,293984,293600,768,768,0
2021-03-20,DI,19,PL53,269856,265888,4288,4288,0
2021-09-08,HO,18,PL11,66280,66168,112,112,0
2021-10-23,PRG,12,PL14,387456,386752,928,928,0
2021-07-02,PW,26,PL37,702576,689952,13872,13872,0
2021-06-03,CH,24,PL57,34340,34292,48,48,0
2021-03-03,CH,24,PL07,268939,254823,26244,11328,14916
2021-08-02,HO,18,PL03,66616,66488,240,240,0
2021-12-04,SD,13,PL20,74445,73906,731,192,539
2021-10-30,CL,14,PL45,224320,220064,8512,8512,0
2021-02-03,SD,13,PL21,69792,68563,1869,624,1245
2021-10-24,PB,25,PL54,377056,339424,46656,46656,0
2021-12-06,RA,17,PL34,113808,85296,28512,28512,0
2021-01-24,CH,24,PL08,281931,250497,40970,9536,31434
2021-03-31,HO,18,PL11,65192,65248,336,336,0
2021-09-01,SD,13,PL22,70129,70006,1979,1856,123
2021-04-24,RT,21,PL42,190112,187456,2912,2912,0
2021-08-12,SD,13,PL20,76091,76016,75,0,75
2021-09-19,DI,19,PL53,295360,294656,992,992,0
2021-01-29,CL,14,PL45,304512,292064,2176,2176,0
2021-01-11,PRG,12,PL12,391136,391072,704,704,0
2021-06-04,PRG,12,PL14,392064,391584,896,896,0
2021-08-12,PR,15,PL12,138560,138688,192,192,0
2021-04-05,HO,18,PL11,66192,66264,0,0,0
2021-02-06,PR,15,PL24,261440,253760,8032,8032,0
2021-05-10,SD,13,PL25,73875,73569,674,368,306
2021-07-14,HO,18,PL10,38480,38320,224,224,0
2021-09-20,CL,14,PL45,292928,288992,3328,3328,0
2021-10-18,HO,18,PL03,66576,66480,104,104,0
2021-11-13,SD,13,PL19,69162,68873,689,400,289
2021-04-15,RA,17,PL56,10488,10488,0,0,0
2021-11-17,HO,18,PL10,68992,68976,96,96,0
2021-04-06,RA,17,PL56,210864,211032,936,936,0
2021-06-21,CA,23,PL02,166920,160344,7032,7032,0
2021-07-04,HO,18,PL33,66224,66224,0,0,0
2021-02-11,HO,18,PL32,68056,68056,88,88,0
2021-07-15,HO,18,PL30,57648,57256,392,392,0
2021-10-29,NT,16,PL51,48448,48288,1056,1056,0
2021-01-05,HO,18,PL09,65104,65080,112,112,0
2021-06-25,DI,19,PL53,259136,256000,3360,3360,0
2021-07-25,SD,13,PL17,71469,70412,1633,576,1057
2021-02-04,HO,18,PL32,67792,67672,208,208,0
2021-03-15,RA,17,PL56,220008,215280,4944,4944,0
2021-11-25,RT,21,PL42,192800,191568,1536,1536,0
2021-12-16,DI,19,PL53,285056,284608,576,576,0
2021-06-23,CH,24,PL07,145388,138946,11578,4992,6586
2021-05-01,RA,17,PL34,219312,219240,264,264,0
2021-05-11,CH,24,PL12,11776,11760,1328,1328,0
2021-11-09,CH,24,PL07,270336,264417,10938,4352,6586
2021-07-04,CH,24,PL08,293137,268231,35279,9984,25295
2021-11-29,HO,18,PL01,23152,22840,312,312,0
2021-10-19,HO,18,PL33,126640,126432,288,288,0
2021-03-04,RA,17,PL35,156720,156192,528,528,0
2021-09-26,CA,23,PL31,85536,85536,0,0,0
2021-04-23,HO,18,PL03,61416,61272,496,496,0
2021-09-22,CH,24,PL12,163504,163504,272,272,0
2021-03-19,HO,18,PL09,45160,44056,1104,1104,0
2021-12-07,CA,23,PL13,79288,79360,232,232,0
2021-08-16,SD,13,PL22,70921,70753,1448,1280,168
2021-04-13,CA,23,PL02,236280,235968,432,432,0
2021-06-11,HO,18,PL30,66224,66224,0,0,0
2021-10-11,PB,25,PL55,158240,48160,110496,110496,0
2021-10-01,CA,23,PL13,85280,85272,208,208,0
2021-01-25,HO,18,PL33,68016,67976,88,88,0
2021-04-16,CL,14,PL44,199904,192288,192,192,0
2021-03-22,SD,13,PL22,50735,50628,4327,4160,167
2021-06-20,CH,24,PL08,299142,289216,21446,11520,9926
2021-10-23,HO,18,PL56,66176,66064,112,112,0
2021-01-17,PRG,12,PL14,392832,392256,864,864,0
2021-02-15,CL,14,PL45,304384,293728,2624,2624,0
2021-08-07,PRG,12,PL14,0,0,26656,26656,0
2021-01-20,SD,13,PL18,73511,73415,349,192,157
2021-07-04,DI,19,PL53,208096,205952,2144,2144,0
2021-11-19,PR,15,PL04,264576,264512,352,352,0
2021-05-28,PR,15,PL12,88400,83408,4992,4992,0
2021-03-10,CL,14,PL45,187232,176288,7744,7744,0
2021-04-16,SD,13,PL22,75266,74830,980,544,436
2021-07-04,EC,10,PL43,567552,561888,5472,5472,0
2021-12-15,CA,23,PL35,33968,33688,368,368,0
2021-10-15,SD,13,PL19,76686,76631,311,176,135
2021-06-04,SB,11,PL50,385920,377088,9728,9728,0
2021-02-04,SB,11,PL36,280368,274992,6000,6000,0
2021-02-09,HO,18,PL32,59224,59184,344,344,0
2021-09-29,CH,24,PL12,163360,162944,576,576,0
2021-10-29,RT,21,PL41,62352,62272,80,80,0
2021-09-02,HO,18,PL01,62120,61048,1072,1072,0
2021-06-05,SB,11,PL50,443072,441600,10656,10656,0
2021-07-27,PRG,12,PL14,395840,394784,1344,1344,0
2021-01-16,CA,23,PL31,164880,156600,9720,9720,0
2021-04-14,CH,24,PL07,273150,260769,21170,5856,15314
2021-01-14,SD,13,PL22,55842,55638,1057,832,225
2021-10-26,SD,13,PL21,15328,15294,372,176,196
2021-09-22,RT,21,PL42,187568,186576,1152,1152,0
2021-05-03,PB,25,PL55,72512,72416,6976,6976,0
2021-02-28,SD,13,PL21,41264,40960,896,384,512
2021-03-07,DI,19,PL52,298976,299392,0,0,0
2021-01-31,PRG,12,PL14,385504,384768,960,960,0
2021-09-07,RT,21,PL41,114272,108144,6128,6128,0
2021-07-20,HO,18,PL10,69176,68936,240,240,0
2021-03-20,SD,13,PL21,16213,10489,11452,5728,5724
2021-11-22,PW,26,PL37,814032,813648,1344,1344,0
2021-12-11,SD,13,PL21,62736,62456,908,624,284
2021-11-21,CH,24,PL24,159008,158624,736,736,0
2021-07-01,HO,18,PL09,71632,71632,88,88,0
2021-12-01,SD,13,PL20,70835,70367,1012,544,468
2021-07-02,PR,15,PL12,137600,137424,1072,1072,0
2021-02-27,DI,19,PL52,136800,136672,416,416,0
2021-02-26,CA,23,PL02,239016,238536,864,864,0
2021-07-09,HO,18,PL01,41824,41512,352,352,0
2021-09-22,CH,24,PL57,32880,32792,168,168,0
2021-09-15,CA,23,PL02,232440,231384,1320,1320,0
2021-09-27,HO,18,PL32,56592,56504,264,264,0
2021-07-13,HO,18,PL10,68360,68264,184,184,0
2021-10-24,SD,13,PL21,64498,64253,421,176,245
2021-05-01,HO,18,PL40,67768,67680,88,88,0
2021-05-24,RA,17,PL34,0,0,0,0,0
2021-02-07,CH,24,PL04,163504,163520,272,272,0
2021-03-24,CH,24,PL12,153120,153136,272,272,0
2021-09-02,RT,21,PL06,75936,75384,4872,4872,0
2021-07-21,PW,26,PL37,761568,760368,5424,5424,0
2021-04-19,HO,18,PL01,37280,37168,168,168,0
2021-05-08,CH,24,PL08,284482,273719,18027,7264,10763
2021-09-02,CA,23,PL31,218832,217944,1296,1296,0
2021-04-20,HO,18,PL11,7016,7040,0,0,0
2021-07-16,PR,15,PL12,127312,124864,2528,2528,0
2021-10-10,RT,21,PL41,0,0,0,0,0
2021-12-20,CH,24,PL08,274779,262846,16718,4608,12110
2021-03-31,CL,14,PL45,103072,101120,2400,2400,0
2021-02-12,CA,23,PL02,213984,209688,5616,5616,0
2021-09-22,PRG,12,PL14,345504,345120,1760,1760,0
2021-09-09,PRG,12,PL14,383008,381824,1760,1760,0
2021-11-19,NT,16,PL51,479872,472192,8640,8640,0
2021-05-04,SB,11,PL36,300024,297840,2616,2616,0
2021-10-09,HO,18,PL32,57576,57432,144,144,0
2021-10-09,EC,10,PL43,617232,616176,1632,1632,0
2021-04-11,CA,23,PL02,228600,227736,1032,1032,0
2021-08-11,CH,24,PL07,308199,292843,23720,8000,15720
2021-03-17,CL,14,PL44,291200,285888,2336,2336,0
2021-04-20,RT,21,PL06,134952,122064,13128,13128,0
2021-01-11,CH,24,PL08,174450,163023,14339,2912,11427
2021-06-01,HO,18,PL03,67120,67064,88,88,0
2021-11-16,CA,23,PL31,113304,109224,5040,5040,0
2021-04-24,HO,18,PL33,65224,65000,224,224,0
2021-10-31,SD,13,PL21,62175,61953,239,0,239
2021-01-30,HO,18,PL33,67408,67048,360,360,0
2021-01-05,SD,13,PL18,70327,68950,1553,176,1377
2021-09-03,CH,24,PL07,310847,309076,6429,4448,1981
2021-06-16,SB,11,PL50,321888,308288,13952,13952,0
2021-09-27,EC,10,PL43,629376,627504,1584,1584,0
2021-03-01,CH,24,PL04,161776,160944,832,832,0
2021-03-31,RA,17,PL34,81216,81216,0,0,0
2021-06-02,HO,18,PL32,68584,68584,0,0,0
2021-01-20,CA,23,PL02,184272,173136,14640,14640,0
2021-06-17,SD,13,PL17,74231,73169,1433,384,1049
2021-01-03,RA,17,PL56,219288,218736,552,552,0
2021-07-06,PRG,12,PL14,221984,221824,13824,13824,0
2021-09-24,SD,13,PL25,76752,75930,1062,176,886
2021-12-21,HO,18,PL32,57128,56880,240,240,0
2021-11-06,PW,26,PL37,807264,807168,1440,1440,0
2021-12-17,RA,17,PL56,260760,260424,600,600,0
2021-07-12,PB,25,PL55,447040,445152,3776,3776,0
2021-08-03,CA,23,PL02,229416,229080,1056,1056,0
2021-09-08,EC,10,PL43,452688,439680,15552,15552,0
2021-01-11,CA,23,PL13,83960,82112,1888,1888,0
2021-09-27,NT,16,PL51,512640,511776,1184,1184,0
2021-08-28,PR,15,PL04,354816,352992,2528,2528,0
2021-04-13,RA,17,PL34,212304,212232,792,792,0
2021-07-14,CA,23,PL31,0,0,2736,2736,0
2021-11-08,SD,13,PL17,70143,70026,307,176,131
2021-02-18,HO,18,PL03,63768,63656,112,112,0
2021-10-08,HO,18,PL56,65536,64408,1128,1128,0
2021-03-04,SD,13,PL20,75990,75663,721,368,353
2021-11-24,CH,24,PL07,268418,260527,10344,2112,8232
2021-11-14,HO,18,PL09,67768,67744,88,88,0
2021-03-24,CH,24,PL07,213435,207374,14576,8416,6160
2021-02-12,SB,11,PL36,313872,313272,768,768,0
2021-10-27,RA,17,PL35,129360,127368,2208,2208,0
2021-12-21,SD,13,PL25,65352,64309,1251,208,1043
2021-03-02,HO,18,PL10,4648,4336,312,312,0
2021-06-29,CA,23,PL31,180456,178920,1872,1872,0
2021-09-24,CA,23,PL31,145272,143328,2664,2664,0
2021-10-11,HO,18,PL11,54672,54560,112,112,0
2021-05-23,CH,24,PL08,266882,261595,15261,9632,5629
2021-03-29,CA,23,PL13,76448,76376,208,208,0
2021-11-24,SD,13,PL21,60763,60411,912,560,352
2021-10-20,RT,21,PL42,160,0,160,160,0
2021-12-12,SB,11,PL36,308400,307728,1056,1056,0
2021-02-10,RA,17,PL56,58464,58200,5448,5448,0
2021-09-18,SD,13,PL19,70839,65994,4961,0,4961
2021-03-07,SD,13,PL19,68316,67188,3329,2192,1137
2021-06-18,HO,18,PL03,52008,51776,232,232,0
2021-03-30,HO,18,PL01,66216,66120,96,96,0
2021-04-05,HO,18,PL03,66152,66248,0,0,0
2021-11-10,PB,25,PL54,5856,5856,0,0,0
2021-12-17,HO,18,PL32,57640,57640,0,0,0
2021-01-10,HO,18,PL03,67704,67744,0,0,0
2021-02-26,SD,13,PL19,76232,75571,855,208,647
2021-04-14,CL,14,PL44,299840,275648,2848,2848,0
2021-01-17,RA,17,PL35,170880,168048,2832,2832,0
2021-07-09,CL,14,PL44,291360,285216,1600,1600,0
2021-03-30,PRG,12,PL14,390560,389856,1504,1504,0
2021-02-06,PR,15,PL57,141520,141488,336,336,0
2021-05-10,PB,25,PL55,444800,441856,6368,6368,0
2021-02-27,RT,21,PL06,209376,209136,432,432,0
2021-03-04,HO,18,PL33,66392,66280,248,248,0
2021-10-18,RT,21,PL05,210288,208968,1464,1464,0
2021-06-22,PR,15,PL04,262848,256608,6240,6240,0
2021-10-06,PB,25,PL55,447200,447776,704,704,0
2021-05-19,RT,21,PL06,168552,166848,1824,1824,0
2021-07-19,HO,18,PL33,65552,65440,112,112,0
2021-09-22,HO,18,PL32,56680,56616,184,184,0
2021-03-03,RA,17,PL56,176568,175512,1128,1128,0
2021-06-28,PB,25,PL55,438912,435520,4192,4192,0
2021-11-22,SD,13,PL18,75654,75347,769,368,401
2021-02-16,PR,15,PL57,126976,126800,176,176,0
2021-02-25,SD,13,PL18,7683,7560,123,0,123
2021-04-25,HO,18,PL01,65192,64480,712,712,0
2021-09-15,EC,10,PL43,622032,622080,1104,1104,0
2021-05-30,SD,13,PL20,74696,73644,1452,400,1052
2021-02-03,HO,18,PL32,48888,48704,1032,1032,0
2021-06-15,HO,18,PL33,132480,132480,0,0,0
2021-08-14,SD,13,PL25,69488,68760,1709,976,733
2021-03-04,SD,13,PL17,72968,72746,974,752,222
2021-05-16,DI,19,PL53,262912,262080,1248,1248,0
2021-11-05,RT,21,PL42,148624,136880,11744,11744,0
2021-06-16,CH,24,PL07,156371,154533,14892,7040,7852
2021-02-21,SD,13,PL19,57280,57121,639,480,159
2021-09-13,PRG,12,PL14,388864,386016,3296,3296,0
2021-07-02,RT,21,PL06,204048,203400,720,720,0
2021-12-03,SD,13,PL21,64423,64065,534,176,358
2021-09-10,HO,18,PL03,66704,66648,136,136,0
2021-01-19,EC,10,PL43,603840,594912,9120,9120,0
2021-06-11,SD,13,PL17,40361,39985,1944,1568,376
2021-02-26,SD,13,PL22,72757,72502,431,176,255
2021-02-10,CH,24,PL04,164256,164176,240,240,0
2021-05-08,CH,24,PL57,21224,21068,164,164,0
2021-10-27,SB,11,PL36,159408,143928,15480,15480,0
2021-05-30,HO,18,PL01,43272,42240,1032,1032,0
2021-10-13,CH,24,PL08,219969,208097,13568,1696,11872
2021-12-08,DI,19,PL53,287168,271040,16544,16544,0
2021-10-10,HO,18,PL56,65496,65256,264,264,0
2021-01-07,CL,14,PL44,304032,301408,896,896,0
2021-05-16,SB,11,PL50,413632,413696,2432,2432,0
2021-05-27,HO,18,PL10,56584,56448,232,232,0
2021-04-24,CH,24,PL08,120095,115019,9080,3904,5176
2021-08-05,CA,23,PL02,83832,83664,456,456,0
2021-08-03,SB,11,PL36,291624,282984,8760,8760,0
2021-03-30,SD,13,PL20,58507,58410,2973,2800,173
2021-07-04,PB,25,PL54,369728,366816,3488,3488,0
2021-02-22,CA,23,PL31,215016,208176,7200,7200,0
2021-12-20,CA,23,PL02,181512,181248,576,576,0
2021-05-08,RA,17,PL35,227640,227640,0,0,0
2021-09-09,CA,23,PL13,59592,59504,88,88,0
2021-07-05,SD,13,PL19,64018,63596,950,528,422
2021-10-18,CA,23,PL02,148488,146256,3576,3576,0
2021-11-25,CH,24,PL24,119280,119104,176,176,0
2021-02-26,HO,18,PL01,63288,62800,872,872,0
2021-03-08,PR,15,PL24,264480,253952,11200,11200,0
2021-05-16,SD,13,PL19,67423,67403,2442,1200,1242
2021-10-29,RT,21,PL06,48408,48048,360,360,0
2021-06-22,HO,18,PL30,65032,64936,136,136,0
2021-09-02,SD,13,PL22,47541,47483,373,192,181
2021-09-05,PRG,12,PL14,396640,396736,384,384,0
2021-07-24,SD,13,PL25,29411,28881,5970,5440,530
2021-02-25,PB,25,PL55,444896,444032,2496,2496,0
2021-06-03,CA,23,PL31,224760,223200,1752,1752,0
2021-05-27,PB,25,PL55,440992,438976,3040,3040,0
2021-01-11,SD,13,PL19,5253,5234,19,0,19
2021-12-11,RA,17,PL56,254928,254832,816,816,0
2021-03-05,CL,14,PL44,253696,240576,11872,11872,0
2021-05-09,SD,13,PL18,73276,73096,568,368,200
2021-05-06,PW,26,PL37,0,0,3408,3408,0
2021-02-20,CH,24,PL08,210976,209920,1504,1504,0
2021-09-12,RA,17,PL34,217464,215016,2448,2448,0
2021-02-28,SB,11,PL50,47776,0,47776,47776,0
2021-05-02,SD,13,PL19,75777,75732,813,768,45
2021-04-14,DI,19,PL52,201216,194176,7488,7488,0
2021-09-20,CH,24,PL12,163424,163216,432,432,0
2021-09-24,HO,18,PL11,66152,65816,336,336,0
2021-11-21,RT,21,PL42,187536,184736,2960,2960,0
2021-06-29,PR,15,PL04,263456,262176,1632,1632,0
2021-09-28,PR,15,PL24,263776,263872,736,736,0
2021-02-13,SD,13,PL20,76283,75986,489,192,297
2021-09-19,RT,21,PL05,208296,208512,24,24,0
2021-09-11,PR,15,PL24,270208,269504,992,992,0
2021-10-28,CH,24,PL07,255347,251796,11137,6080,5057
2021-05-02,DI,19,PL52,290592,289216,1888,1888,0
2021-04-24,PW,26,PL37,814560,813456,1680,1680,0
2021-02-21,NT,16,PL51,468544,468480,832,832,0
2021-03-09,SD,13,PL17,73182,72822,793,352,441
2021-09-27,CA,23,PL02,186144,186120,672,672,0
2021-04-07,DI,19,PL52,203936,203936,0,0,0
2021-05-20,SD,13,PL17,55264,54868,3485,3008,477
2021-10-23,SD,13,PL22,75872,75838,108,0,108
2021-11-27,SD,13,PL22,76656,76579,77,0,77
2021-12-06,HO,18,PL40,4344,4248,96,96,0
2021-07-03,EC,10,PL43,628560,627072,1680,1680,0
2021-02-12,DI,19,PL53,264384,261440,3264,3264,0
2021-06-20,NT,16,PL51,467616,466752,1824,1824,0
2021-10-28,HO,18,PL09,67392,67296,96,96,0
2021-12-06,CH,24,PL57,33988,33944,44,44,0
2021-12-13,CA,23,PL13,84736,84776,88,88,0
2021-08-30,SD,13,PL19,74268,74227,257,208,49
2021-07-18,HO,18,PL30,66224,66224,0,0,0
2021-09-10,PR,15,PL24,198816,188416,10400,10400,0
2021-03-22,HO,18,PL11,65440,65360,104,104,0
2021-06-09,CH,24,PL07,26705,26127,706,128,578
2021-11-09,HO,18,PL40,66288,66288,0,0,0
2021-02-17,SD,13,PL18,72446,71501,1452,464,988
2021-09-03,CL,14,PL45,235968,218400,10496,10496,0
2021-04-17,PB,25,PL55,345568,326624,19488,19488,0
2021-09-06,CL,14,PL44,298880,294656,3616,3616,0
2021-05-16,NT,16,PL51,428000,428224,352,352,0
2021-03-15,CA,23,PL31,232584,232248,336,336,0
2021-08-28,PR,15,PL24,262816,259392,3872,3872,0
2021-11-01,HO,18,PL09,67184,67136,88,88,0
2021-11-29,CA,23,PL13,3160,0,3160,3160,0
2021-02-06,RA,17,PL35,220152,219264,1056,1056,0
2021-04-10,EC,10,PL43,619392,616704,2544,2544,0
2021-01-12,HO,18,PL30,66160,66160,0,0,0
2021-03-23,HO,18,PL03,66224,66200,24,24,0
2021-04-10,SD,13,PL17,73766,73596,714,544,170
2021-02-15,HO,18,PL11,65608,65504,104,104,0
2021-09-05,CH,24,PL08,293529,279460,19559,3616,15943
2021-04-15,HO,18,PL33,63240,63240,0,0,0
2021-10-09,SD,13,PL21,65039,64758,464,176,288
2021-03-11,CL,14,PL45,273408,265920,1920,1920,0
2021-04-17,HO,18,PL09,37848,37680,232,232,0
2021-07-09,CA,23,PL11,231096,230688,1032,1032,0
2021-01-05,PR,15,PL24,264480,264000,480,480,0
2021-01-29,HO,18,PL32,60736,60184,552,552,0
2021-02-05,CH,24,PL04,163680,163600,240,240,0
2021-04-03,CH,24,PL07,100540,92992,11327,3040,8287
2021-05-17,CL,14,PL44,213824,177408,4288,4288,0
2021-09-09,NT,16,PL51,458624,453664,7168,7168,0
2021-07-01,PR,15,PL04,263936,262144,2080,2080,0
2021-12-02,RA,17,PL56,175416,174792,984,984,0
2021-10-28,NT,16,PL51,508832,506816,2496,2496,0
2021-10-16,HO,18,PL03,64552,64288,264,264,0
2021-09-19,HO,18,PL33,132512,132512,0,0,0
2021-12-13,PR,15,PL04,262464,261856,1184,1184,0
2021-02-17,PR,15,PL24,260736,258208,3264,3264,0
2021-06-22,SD,13,PL21,73576,73051,925,384,541
2021-07-22,RT,21,PL41,60144,47920,12224,12224,0
2021-10-23,SD,13,PL18,74519,74018,917,416,501
2021-07-05,SB,11,PL50,398720,393216,5920,5920,0
2021-05-07,HO,18,PL32,67328,67144,216,216,0
2021-03-07,EC,10,PL43,613872,612432,1824,1824,0
2021-02-24,CL,14,PL44,225248,219968,832,832,0
2021-09-07,SD,13,PL25,75954,75152,994,192,802
2021-05-18,SD,13,PL22,9929,9288,1266,624,642
2021-10-12,DI,19,PL53,287200,285376,1952,1952,0
2021-02-27,HO,18,PL10,48496,48288,304,304,0
2021-07-28,HO,18,PL30,66216,66216,0,0,0
2021-01-02,CA,23,PL31,160896,159936,1560,1560,0
2021-04-20,SD,13,PL20,60724,60646,729,448,281
2021-09-29,SD,13,PL25,75001,73725,1650,368,1282
2021-02-19,HO,18,PL03,66224,66224,0,0,0
2021-09-07,CH,24,PL57,20260,20204,56,56,0
2021-06-08,RT,21,PL05,200232,199512,1032,1032,0
2021-09-01,SD,13,PL20,63536,63562,1511,1456,55
2021-09-25,HO,18,PL11,66104,65784,352,352,0
2021-02-01,RT,21,PL42,178288,175792,2496,2496,0
2021-04-02,CA,23,PL02,234264,233184,1296,1296,0
2021-07-05,DI,19,PL53,25376,25376,0,0,0
2021-06-19,SB,11,PL50,462816,461888,1440,1440,0
2021-09-05,RT,21,PL42,191616,190720,1024,1024,0
2021-10-09,PRG,12,PL14,390048,390176,1152,1152,0
2021-11-25,CH,24,PL07,102221,95941,9128,2848,6280
2021-02-22,HO,18,PL32,67688,67608,96,96,0
2021-06-09,RA,17,PL56,195552,194688,864,864,0
2021-06-01,SD,13,PL20,61100,60703,1015,576,439
2021-01-15,RA,17,PL34,222816,223104,0,0,0
2021-06-16,SD,13,PL19,67678,67649,240,192,48
2021-03-01,RT,21,PL06,149184,141816,7536,7536,0
2021-10-03,EC,10,PL43,587808,585312,2496,2496,0
2021-07-13,CA,23,PL02,32784,32784,0,0,0
2021-03-08,DI,19,PL52,296960,296448,704,704,0
2021-09-08,NT,16,PL51,513952,514624,416,416,0
2021-08-22,CH,24,PL07,171555,167068,25797,21056,4741
2021-11-07,HO,18,PL03,66568,66488,80,80,0
2021-05-04,CH,24,PL08,300311,291544,12914,3872,9042
2021-03-04,SB,11,PL36,312456,311616,1248,1248,0
2021-03-02,DI,19,PL53,296800,295584,1632,1632,0
2021-10-25,HO,18,PL03,66528,66424,176,176,0
2021-06-22,CH,24,PL57,34096,34060,44,44,0
2021-11-19,SD,13,PL19,75091,74926,566,400,166
2021-02-04,SD,13,PL17,72660,71488,1619,384,1235
2021-05-19,NT,16,PL51,462368,462752,1728,1728,0
2021-11-21,SD,13,PL20,61185,60975,794,576,218
2021-04-21,CH,24,PL12,163568,163168,512,512,0
2021-06-28,PRG,12,PL14,392672,392224,896,896,0
2021-03-17,HO,18,PL01,64120,64048,192,192,0
2021-06-23,PRG,12,PL14,380032,379168,864,864,0
2021-10-09,SD,13,PL18,68825,67886,1131,192,939
2021-07-11,PR,15,PL12,139936,139824,208,208,0
2021-07-24,HO,18,PL56,34040,33592,792,792,0
2021-08-03,PR,15,PL12,138384,138240,272,272,0
2021-05-07,SD,13,PL22,32058,31895,898,544,354
2021-07-20,PB,25,PL54,449056,448544,896,896,0
2021-08-23,SD,13,PL18,76358,75961,573,176,397
2021-09-27,RT,21,PL05,195096,193968,1152,1152,0
2021-12-06,DI,19,PL53,297952,295616,2464,2464,0
2021-09-10,HO,18,PL09,72168,71960,264,264,0
2021-10-15,HO,18,PL40,66264,65960,304,304,0
2021-11-30,DI,19,PL52,260288,260384,480,480,0
2021-01-27,HO,18,PL33,67952,67848,128,128,0
2021-02-28,HO,18,PL30,41984,40640,1344,1344,0
2021-04-06,CA,23,PL13,54920,54952,712,712,0
2021-03-25,NT,16,PL57,126896,126624,1536,1536,0
2021-07-29,RT,21,PL41,50736,29616,23472,23472,0
2021-06-20,PRG,12,PL14,391968,391232,960,960,0
2021-11-09,SD,13,PL18,75220,74809,1403,992,411
2021-04-29,CH,24,PL07,279830,269430,23174,12480,10694
2021-08-03,RA,17,PL34,219048,218088,1248,1248,0
2021-02-20,SD,13,PL25,69029,68980,450,400,50
2021-11-16,SD,13,PL22,75302,75078,416,192,224
2021-09-13,PR,15,PL24,262848,261632,1632,1632,0
2021-02-20,RA,17,PL56,222432,222672,0,0,0
2021-12-18,SD,13,PL21,76504,75846,820,176,644
2021-11-16,HO,18,PL10,68336,68328,128,128,0
2021-02-11,PB,25,PL55,319328,317888,2656,2656,0
2021-03-02,SD,13,PL17,69497,69460,262,176,86
2021-07-26,HO,18,PL33,65904,65824,152,152,0
2021-11-05,SB,11,PL50,462144,461696,2784,2784,0
2021-01-03,HO,18,PL10,0,0,976,976,0
2021-06-18,RT,21,PL42,0,0,5840,5840,0
2021-08-26,HO,18,PL01,67544,67264,384,384,0
2021-11-23,SB,11,PL50,451296,451232,3744,3744,0
2021-01-08,CH,24,PL57,34156,34108,48,48,0
2021-02-02,PW,26,PL37,276240,274416,2784,2784,0
2021-01-29,RT,21,PL05,204840,204576,408,408,0
2021-06-25,HO,18,PL40,61288,61176,112,112,0
2021-10-14,RT,21,PL41,179568,175776,3824,3824,0
2021-06-01,RT,21,PL06,206976,206808,288,288,0
2021-04-10,CA,23,PL13,79904,79824,432,432,0
2021-06-06,HO,18,PL32,67792,67696,96,96,0
2021-03-23,HO,18,PL10,54800,53408,1536,1536,0
2021-08-13,SD,13,PL22,76680,76581,113,0,113
2021-08-26,HO,18,PL03,66984,66816,232,232,0
2021-08-31,SD,13,PL22,44147,44007,5294,5120,174
2021-07-01,HO,18,PL30,66160,66056,104,104,0
2021-03-08,PRG,12,PL14,314496,295168,19328,19328,0
2021-06-15,DI,19,PL53,292096,291104,1120,1120,0
2021-01-16,SD,13,PL19,62059,61806,445,192,253
2021-06-19,CA,23,PL02,230760,230640,312,312,0
2021-11-03,HO,18,PL11,65632,65528,104,104,0
2021-10-17,DI,19,PL52,200576,200192,384,384,0
2021-01-03,EC,10,PL43,68384,68080,208,208,0
2021-02-28,NT,16,PL57,154848,154928,0,0,0
2021-05-17,RT,21,PL05,174552,173400,1272,1272,0
2021-06-23,HO,18,PL33,132336,132096,240,240,0
2021-05-03,CH,24,PL12,53440,52112,1984,1984,0
2021-05-25,CL,14,PL45,241536,212640,13696,13696,0
2021-03-10,SB,11,PL36,315288,314712,1104,1104,0
2021-10-03,CH,24,PL12,164640,164368,272,272,0
2021-03-12,SD,13,PL17,0,0,557,160,397
2021-09-20,PRG,12,PL14,386784,385952,1376,1376,0
2021-10-19,CA,23,PL13,52048,52104,0,0,0
2021-09-13,HO,18,PL40,66280,66280,0,0,0
2021-04-28,SD,13,PL18,13643,13492,2231,2080,151
2021-11-25,RA,17,PL34,165264,160896,4992,4992,0
2021-08-20,CA,23,PL31,48672,46776,2328,2328,0
2021-02-27,RA,17,PL56,220344,220032,552,552,0
2021-03-21,DI,19,PL53,235584,235168,736,736,0
2021-05-04,RA,17,PL34,220584,220152,528,528,0
2021-05-31,DI,19,PL53,250432,250432,1536,1536,0
2021-06-17,HO,18,PL09,70152,70064,200,200,0
2021-11-01,CH,24,PL24,162016,161616,2128,2128,0
2021-01-14,HO,18,PL30,66048,66144,0,0,0
2021-10-10,SB,11,PL50,452096,449792,2784,2784,0
2021-12-15,HO,18,PL03,9000,8696,304,304,0
2021-02-24,RT,21,PL06,209184,209016,288,288,0
2021-10-19,RT,21,PL06,208344,207864,552,552,0
2021-04-26,HO,18,PL03,63808,63520,312,312,0
2021-07-15,HO,18,PL09,72192,72208,96,96,0
2021-12-16,PR,15,PL24,134720,130784,4224,4224,0
2021-09-14,RA,17,PL34,174576,168672,5904,5904,0
2021-11-21,CL,14,PL45,297600,293216,800,800,0
2021-01-11,CA,23,PL02,238176,238176,408,408,0
2021-09-25,HO,18,PL40,21088,20936,152,152,0
2021-04-23,HO,18,PL09,71080,70984,96,96,0
2021-11-11,NT,16,PL51,472608,471328,2304,2304,0
2021-11-24,HO,18,PL40,65344,65024,320,320,0
2021-02-06,RT,21,PL42,179008,177280,1808,1808,0
2021-12-16,CA,23,PL13,80496,80216,400,400,0
2021-05-08,SD,13,PL17,67064,65838,2029,784,1245
2021-04-17,HO,18,PL01,33536,33512,144,144,0
2021-08-25,HO,18,PL09,72056,71920,192,192,0
2021-04-17,CA,23,PL13,68880,68936,0,0,0
2021-06-21,HO,18,PL32,62952,62944,112,112,0
2021-08-26,CA,23,PL31,117888,117048,840,840,0
2021-04-10,CH,24,PL07,284545,279267,11069,5664,5405
2021-09-06,EC,10,PL43,0,0,2784,2784,0
2021-05-01,HO,18,PL30,65184,65168,96,96,0
2021-10-10,SD,13,PL20,72636,72041,1143,544,599
2021-12-15,DI,19,PL53,296160,295840,736,736,0
2021-07-02,HO,18,PL40,66032,65832,240,240,0
2021-08-26,CH,24,PL08,216583,207474,17461,8352,9109
2021-02-28,NT,16,PL51,471520,471520,448,448,0
2021-08-10,PR,15,PL24,264544,264384,352,352,0
2021-12-20,PW,26,PL37,807888,805776,3792,3792,0
2021-04-14,CA,23,PL02,221472,218208,3528,3528,0
2021-02-21,RT,21,PL06,209640,209640,0,0,0
2021-12-09,DI,19,PL52,293376,292832,864,864,0
2021-10-02,SD,13,PL20,69594,69107,1639,1136,503
2021-02-25,NT,16,PL51,463648,463968,416,416,0
2021-11-12,HO,18,PL30,1040,256,784,784,0
2021-04-14,PRG,12,PL14,391776,391808,768,768,0
2021-10-26,PB,25,PL54,221856,205632,17600,17600,0
2021-10-18,PB,25,PL55,0,0,31776,31776,0
2021-03-04,CH,24,PL04,163424,163296,224,224,0
2021-01-08,HO,18,PL10,39888,36264,3624,3624,0
2021-09-17,CH,24,PL57,34240,34228,48,48,0
2021-10-02,NT,16,PL51,439200,437472,2336,2336,0
2021-03-01,PRG,12,PL14,290240,284192,6848,6848,0
2021-02-23,SD,13,PL21,69741,69257,1155,624,531
2021-01-11,RA,17,PL56,181080,178680,3864,3864,0
2021-11-24,SB,11,PL36,45480,43344,14496,14496,0
2021-10-03,SB,11,PL50,457824,456512,3264,3264,0
2021-08-25,CH,24,PL12,163136,162864,528,528,0
2021-10-22,HO,18,PL33,129152,129008,432,432,0
2021-11-28,CH,24,PL12,164704,164448,256,256,0
2021-12-15,SD,13,PL19,75975,75933,490,368,122
2021-07-19,CA,23,PL11,0,0,0,0,0
2021-04-17,CH,24,PL12,86992,87008,208,208,0
2021-01-13,CA,23,PL31,230520,228360,2544,2544,0
2021-02-17,CH,24,PL07,270934,265677,9897,4640,5257
2021-06-10,CL,14,PL45,113376,95488,13088,13088,0
2021-03-19,NT,16,PL51,462144,458528,3936,3936,0
2021-01-22,RA,17,PL35,165048,160416,6072,6072,0
2021-08-05,HO,18,PL30,18112,18048,128,128,0
2021-12-01,SD,13,PL21,64579,64090,868,368,500
2021-01-26,RA,17,PL56,21792,21792,0,0,0
2021-03-08,RA,17,PL56,220104,219264,912,912,0
2021-08-04,RT,21,PL05,73992,69672,4320,4320,0
2021-09-16,HO,18,PL01,68216,67992,224,224,0
2021-01-14,SB,11,PL50,452448,447872,4864,4864,0
2021-11-07,SB,11,PL50,453248,452480,1984,1984,0
2021-05-15,CH,24,PL08,286252,277640,25661,17024,8637
2021-06-25,SD,13,PL25,71628,70752,1278,400,878
2021-02-05,RA,17,PL56,217200,215904,1296,1296,0
2021-10-26,HO,18,PL11,61032,61024,136,136,0
2021-02-20,SB,11,PL36,314880,314040,1368,1368,0
2021-12-18,RT,21,PL05,177312,176448,1080,1080,0
2021-08-15,SD,13,PL22,14591,14428,1779,1616,163
2021-06-01,CL,14,PL44,245504,238400,3488,3488,0
2021-09-20,SD,13,PL19,74629,74500,378,176,202
2021-07-13,CH,24,PL08,310194,307601,6561,3968,2593
2021-03-03,HO,18,PL11,66176,66232,0,0,0
2021-02-21,SD,13,PL22,72211,72059,632,480,152
2021-07-31,HO,18,PL09,1424,1424,0,0,0
2021-01-15,CL,14,PL44,221888,185088,4416,4416,0
2021-05-03,DI,19,PL52,294432,294592,0,0,0
2021-09-29,NT,16,PL51,486880,485600,2208,2208,0
2021-09-11,SD,13,PL22,76070,76047,263,192,71
2021-04-13,HO,18,PL33,64416,64288,352,352,0
2021-06-19,RA,17,PL34,68064,64680,3384,3384,0
2021-05-16,SB,11,PL36,267480,262320,7944,7944,0
2021-09-28,HO,18,PL09,67704,67632,112,112,0
2021-10-11,SD,13,PL20,76300,75736,771,176,595
2021-01-09,SD,13,PL19,55856,55513,3856,3552,304
2021-07-01,CA,23,PL31,158640,155976,3072,3072,0
2021-01-13,SD,13,PL17,72912,72593,495,176,319
2021-12-02,RT,21,PL06,166440,164880,3360,3360,0
2021-02-19,HO,18,PL33,67784,67328,552,552,0
2021-11-11,HO,18,PL09,67568,67296,464,464,0
2021-06-25,RA,17,PL34,191904,190272,1632,1632,0
2021-08-04,SD,13,PL20,76265,76165,452,352,100
2021-09-20,PR,15,PL24,266144,264480,1920,1920,0
2021-06-14,PB,25,PL55,448896,448160,992,992,0
2021-09-21,HO,18,PL10,68448,68456,88,88,0
2021-03-18,RT,21,PL42,137440,136368,5120,5120,0
2021-10-24,SD,13,PL19,54567,54010,2511,1968,543
2021-10-17,HO,18,PL40,66200,66224,0,0,0
2021-11-27,NT,16,PL51,153760,149120,5376,5376,0
2021-10-18,SD,13,PL20,75166,75085,516,352,164
2021-04-06,SD,13,PL18,54807,54012,1367,544,823
2021-05-26,CH,24,PL08,292904,286361,15343,8800,6543
2021-02-04,SB,11,PL50,450656,448768,1984,1984,0
2021-04-16,DI,19,PL52,30272,30528,0,0,0
2021-09-25,HO,18,PL09,67600,67592,96,96,0
2021-12-15,RT,21,PL41,0,0,0,0,0
2021-12-12,CH,24,PL08,167267,129377,39330,1440,37890
2021-11-10,HO,18,PL03,22088,22088,0,0,0
2021-10-31,SD,13,PL17,67894,67688,558,352,206
2021-11-10,HO,18,PL10,68240,68152,88,88,0
2021-04-24,SD,13,PL21,16109,14690,2491,1072,1419
2021-04-09,PB,25,PL54,357920,334560,24064,24064,0
2021-06-10,HO,18,PL32,68008,67912,96,96,0
2021-10-13,CA,23,PL13,85112,85128,104,104,0
2021-03-15,HO,18,PL11,64488,64456,112,112,0
2021-05-20,RT,21,PL42,154464,152080,4160,4160,0
2021-09-02,RA,17,PL35,151320,149064,4944,4944,0
2021-12-19,PB,25,PL54,433056,431424,1984,1984,0
2021-03-16,CA,23,PL13,85248,85176,176,176,0
2021-05-29,SD,13,PL21,67012,66742,772,480,292
2021-09-19,SD,13,PL19,72564,70219,3361,928,2433
2021-01-05,HO,18,PL03,67784,67784,0,0,0
2021-02-03,HO,18,PL03,7880,7056,1616,1616,0
2021-05-02,SD,13,PL22,68630,67994,1406,768,638
2021-03-27,NT,16,PL51,323616,320128,3808,3808,0
2021-05-08,HO,18,PL40,64472,64360,112,112,0
2021-05-16,PB,25,PL54,333216,311680,22496,22496,0
2021-10-13,HO,18,PL01,67184,66680,504,504,0
2021-02-03,CL,14,PL44,217056,212448,1088,1088,0
2021-02-27,SB,11,PL50,1792,0,1792,1792,0
2021-04-09,CA,23,PL31,185904,185016,1296,1296,0
2021-04-28,RA,17,PL35,222528,221064,1608,1608,0
2021-04-17,RA,17,PL56,172608,171624,1392,1392,0
2021-04-23,SD,13,PL19,76310,76288,614,592,22
2021-03-26,CA,23,PL31,143520,140664,3672,3672,0
2021-10-27,HO,18,PL09,67360,66920,480,480,0
2021-08-25,CH,24,PL08,365,311,54,0,54
2021-02-26,RA,17,PL56,219408,218928,552,552,0
2021-03-24,SB,11,PL50,343968,335584,8800,8800,0
2021-10-28,PR,15,PL04,0,0,7168,7168,0
2021-09-15,DI,19,PL52,265760,265536,384,384,0
2021-10-03,RT,21,PL05,205200,205080,264,264,0
2021-07-20,CH,24,PL07,0,0,888,672,216
2021-11-04,RT,21,PL41,170864,159744,11232,11232,0
2021-04-12,RA,17,PL56,219096,218160,1224,1224,0
2021-11-12,HO,18,PL40,54624,54032,592,592,0
2021-04-24,PRG,12,PL14,391936,389664,2336,2336,0
2021-06-14,CA,23,PL31,233352,231312,2376,2376,0
2021-01-25,CA,23,PL31,183936,182352,1944,1944,0
2021-03-24,CL,14,PL45,299872,290432,4320,4320,0
2021-07-31,SD,13,PL19,64626,64592,34,0,34
2021-03-28,HO,18,PL03,55400,54232,3360,3360,0
2021-03-01,RT,21,PL05,148992,145464,4032,4032,0
2021-09-26,HO,18,PL40,66288,66288,0,0,0
2021-12-08,HO,18,PL10,68392,68464,96,96,0
2021-01-13,CH,24,PL57,34204,34156,60,60,0
2021-07-13,CA,23,PL11,26640,26640,0,0,0
2021-11-11,PR,15,PL04,263520,263648,800,800,0
2021-10-26,SD,13,PL20,76290,75995,663,368,295
2021-01-04,RT,21,PL42,92128,89136,3280,3280,0
2021-04-02,HO,18,PL10,56936,56848,88,88,0
2021-10-29,HO,18,PL09,22016,22016,0,0,0
2021-04-06,CL,14,PL44,209056,201216,5472,5472,0
2021-09-24,RT,21,PL41,150640,148704,3456,3456,0
2021-10-28,RA,17,PL34,27648,27072,2400,2400,0
2021-02-17,DI,19,PL52,296256,296320,576,576,0
2021-07-03,CH,24,PL57,34040,33996,44,44,0
2021-06-25,HO,18,PL33,131360,130704,704,704,0
2021-01-28,CL,14,PL45,285792,269248,4128,4128,0
2021-03-08,HO,18,PL33,67168,66912,352,352,0
2021-05-22,HO,18,PL09,72576,72624,0,0,0
2021-02-02,SD,13,PL21,39018,39349,4701,3776,925
2021-03-03,HO,18,PL01,65640,64992,648,648,0
2021-09-11,SD,13,PL21,71979,71628,687,336,351
2021-06-27,HO,18,PL40,66288,65696,592,592,0
2021-02-08,DI,19,PL53,296928,296960,384,384,0
2021-05-15,HO,18,PL10,0,0,312,312,0
2021-12-06,CA,23,PL02,194376,193392,1176,1176,0
2021-03-08,HO,18,PL09,71304,71208,96,96,0
2021-10-23,DI,19,PL53,295520,295968,384,384,0
2021-12-21,CA,23,PL13,71128,69704,1432,1432,0
2021-03-06,CL,14,PL44,301408,297952,1920,1920,0
2021-05-26,SD,13,PL25,22805,22183,6110,5488,622
2021-07-16,SD,13,PL17,70573,68411,2550,368,2182
2021-07-30,CH,24,PL07,273836,257942,27147,10464,16683
2021-11-28,HO,18,PL40,64272,64176,216,216,0
2021-02-18,RT,21,PL05,208632,207648,1584,1584,0
2021-02-21,PB,25,PL55,346720,342944,8288,8288,0
2021-02-24,DI,19,PL52,296896,296384,736,736,0
2021-08-18,SD,13,PL25,0,0,0,0,0
2021-07-24,RT,21,PL05,131136,130296,960,960,0
2021-08-15,HO,18,PL11,66272,66272,0,0,0
2021-06-18,SB,11,PL36,314448,312696,1752,1752,0
2021-01-23,RA,17,PL34,218232,218136,264,264,0
2021-06-12,HO,18,PL40,66248,66304,0,0,0
2021-09-13,CA,23,PL13,74600,74600,272,272,0
2021-07-27,HO,18,PL09,72360,72264,96,96,0
2021-01-06,HO,18,PL30,66072,66104,0,0,0
2021-08-12,RA,17,PL34,221880,221208,816,816,0
2021-05-31,SB,11,PL50,458976,454944,4544,4544,0
2021-09-17,CA,23,PL02,182136,179256,3096,3096,0
2021-10-28,CH,24,PL24,164864,164784,192,192,0
2021-02-11,CL,14,PL45,300928,291840,1824,1824,0
2021-08-15,CA,23,PL31,228864,227544,1584,1584,0
2021-10-02,HO,18,PL56,64696,64168,576,576,0
2021-10-10,HO,18,PL01,67088,66216,920,920,0
2021-03-11,CA,23,PL02,21288,21288,0,0,0
2021-05-28,HO,18,PL30,62168,61984,184,184,0
2021-06-13,PRG,12,PL14,391392,390496,1056,1056,0
2021-04-25,SD,13,PL21,72233,72247,736,736,0
2021-12-21,PW,26,PL37,796896,794208,3504,3504,0
2021-05-02,PR,15,PL57,141040,141024,192,192,0
2021-02-24,SD,13,PL20,70511,70244,827,560,267
2021-08-09,CH,24,PL07,155667,141648,25346,5984,19362
2021-01-30,SB,11,PL36,310224,308856,1728,1728,0
2021-06-25,HO,18,PL30,66216,66216,0,0,0
2021-12-02,RT,21,PL41,88400,36208,52192,52192,0
2021-01-15,PB,25,PL55,447072,439552,8512,8512,0
2021-10-15,HO,18,PL11,65528,65384,144,144,0
2021-10-26,SD,13,PL19,74948,74831,682,544,138
2021-12-15,HO,18,PL11,65064,64784,280,280,0
2021-01-12,RA,17,PL35,220272,219528,1200,1200,0
2021-10-15,HO,18,PL01,67208,66776,504,504,0
2021-03-04,SD,13,PL18,73337,72337,1437,368,1069
2021-10-05,HO,18,PL01,62696,62320,400,400,0
2021-12-11,SD,13,PL17,59210,57827,1559,176,1383
2021-03-16,CL,14,PL44,302528,298688,896,896,0
2021-07-16,HO,18,PL40,64848,63584,1568,1568,0
2021-04-30,PW,26,PL37,761712,758640,3888,3888,0
2021-02-15,CH,24,PL08,298624,295520,4224,4224,0
2021-08-17,RT,21,PL05,70656,70656,0,0,0
2021-08-08,EC,10,PL43,630240,627072,2832,2832,0
2021-05-09,CH,24,PL07,292544,276212,19410,2976,16434
2021-06-05,DI,19,PL52,289408,288192,1600,1600,0
2021-03-12,HO,18,PL32,66912,66808,144,144,0
2021-03-21,NT,16,PL51,468480,467744,1152,1152,0
2021-06-10,RT,21,PL05,181704,179616,2256,2256,0
2021-12-08,SB,11,PL36,278664,277656,6504,6504,0
2021-07-15,SD,13,PL25,0,0,183,0,183
2021-04-27,DI,19,PL52,102784,103072,0,0,0
2021-06-13,PR,15,PL24,264512,264704,448,448,0
2021-01-29,PRG,12,PL14,363968,359552,4416,4416,0
2021-02-03,HO,18,PL01,66088,65480,608,608,0
2021-05-02,RA,17,PL35,225600,225696,264,264,0
2021-04-05,CA,23,PL31,31104,30120,3744,3744,0
2021-01-28,RA,17,PL34,219504,217944,1680,1680,0
2021-04-25,NT,16,PL51,470784,469984,1056,1056,0
2021-03-03,CL,14,PL44,0,0,0,0,0
2021-08-19,HO,18,PL10,60120,59920,352,352,0
2021-08-25,CA,23,PL13,4544,4544,1248,1248,0
2021-04-15,RT,21,PL05,209640,209352,288,288,0
2021-05-20,CH,24,PL57,18660,18608,108,108,0
2021-11-27,PB,25,PL55,377536,367200,11072,11072,0
2021-05-05,SD,13,PL19,74480,74524,1742,1712,30
2021-02-20,RA,17,PL35,219840,218928,1128,1128,0
2021-08-15,SB,11,PL36,239472,229800,9960,9960,0
2021-01-07,SB,11,PL50,0,0,2400,2400,0
2021-03-11,SD,13,PL17,8489,8162,1493,384,1109
2021-09-23,HO,18,PL10,68096,68032,112,112,0
2021-09-15,RA,17,PL35,36408,29928,6480,6480,0
2021-03-10,CA,23,PL13,84056,84048,88,88,0
2021-04-10,DI,19,PL53,298208,297376,992,992,0
2021-03-02,HO,18,PL09,31752,31592,192,192,0
2021-03-07,SD,13,PL20,66556,66251,1025,720,305
2021-12-11,HO,18,PL09,65120,65080,136,136,0
2021-03-06,SD,13,PL20,75925,75761,634,368,266
2021-10-26,HO,18,PL40,56432,56416,16,16,0
2021-06-08,SB,11,PL36,303576,300336,3648,3648,0
2021-06-18,HO,18,PL33,132128,131952,224,224,0
2021-09-13,RA,17,PL34,217008,214584,2544,2544,0
2021-11-10,CA,23,PL13,82936,82464,720,720,0
2021-11-11,CH,24,PL24,144416,143504,1120,1120,0
2021-06-28,RT,21,PL42,192560,190512,2608,2608,0
2021-09-26,SD,13,PL19,61782,61705,477,400,77
2021-08-20,CA,23,PL02,59160,59160,840,840,0
2021-10-04,SB,11,PL50,115552,110720,5728,5728,0
2021-11-10,RT,21,PL41,133968,132080,1888,1888,0
2021-03-23,PR,15,PL04,232672,229120,4544,4544,0
2021-11-16,SD,13,PL19,76384,76199,377,192,185
2021-03-21,SD,13,PL25,71084,70845,635,368,267
2021-01-22,CH,24,PL57,33932,33892,92,92,0
2021-05-19,RT,21,PL41,25440,20752,5488,5488,0
2021-12-16,PRG,12,PL14,369504,368384,2560,2560,0
2021-02-17,HO,18,PL03,64616,64400,424,424,0
2021-11-24,CH,24,PL08,299744,296000,3744,3744,0
2021-08-11,CL,14,PL45,295552,292448,1888,1888,0
2021-11-18,SD,13,PL17,66696,66504,383,176,207
2021-02-10,PW,26,PL37,815040,812064,5088,5088,0
2021-03-09,PR,15,PL24,264576,263936,896,896,0
2021-03-01,SD,13,PL20,73990,73703,1067,720,347
2021-11-05,SD,13,PL18,69148,68724,1921,1472,449
2021-12-15,HO,18,PL33,14016,13928,160,160,0
2021-01-07,HO,18,PL09,66288,66288,0,0,0
2021-01-29,HO,18,PL33,67088,66912,336,336,0
2021-02-20,HO,18,PL03,61736,61456,520,520,0
2021-01-04,SD,13,PL21,73009,71320,1922,176,1746
2021-02-06,NT,16,PL51,463424,461152,3072,3072,0
2021-10-05,SD,13,PL21,65678,65445,750,464,286
2021-10-18,SB,11,PL36,18384,0,18384,18384,0
2021-02-22,SD,13,PL22,70593,70523,1047,912,135
2021-06-05,RT,21,PL05,206856,206496,600,600,0
2021-06-17,EC,10,PL43,629952,627360,2496,2496,0
2021-09-29,SD,13,PL21,64542,64179,797,432,365
2021-10-16,SB,11,PL36,308184,305496,3624,3624,0
2021-02-27,SD,13,PL22,71217,71103,563,384,179
2021-09-06,HO,18,PL33,99616,99040,576,576,0
2021-05-10,SB,11,PL50,446208,445568,1376,1376,0
2021-04-08,CL,14,PL45,302752,298272,1280,1280,0
2021-08-07,HO,18,PL09,27040,26344,696,696,0
2021-03-25,HO,18,PL10,55536,55328,312,312,0
2021-10-01,SD,13,PL21,64143,63787,564,192,372
2021-10-19,CH,24,PL08,187641,175656,21713,9728,11985
2021-10-07,DI,19,PL52,204800,204800,384,384,0
2021-02-03,SB,11,PL50,285568,270688,14944,14944,0
2021-04-04,CH,24,PL08,121301,116532,15160,8352,6808
2021-07-20,RT,21,PL42,190640,189488,1664,1664,0
2021-04-30,RT,21,PL06,202368,202176,336,336,0
2021-03-04,SD,13,PL21,72450,71867,1398,736,662
2021-02-27,SD,13,PL18,62576,61343,1409,176,1233
2021-09-29,RT,21,PL06,167184,166800,4680,4680,0
2021-04-17,CH,24,PL07,227952,210902,27578,10528,17050
2021-02-04,HO,18,PL01,53760,52456,1304,1304,0
2021-05-07,SD,13,PL18,65661,65195,2660,2128,532
2021-07-11,PB,25,PL54,296704,275072,21952,21952,0
2021-06-27,CA,23,PL02,221880,218544,3552,3552,0
2021-11-11,SB,11,PL50,459776,459296,1056,1056,0
2021-02-07,SD,13,PL18,74173,73686,701,192,509
2021-02-23,HO,18,PL01,65352,65016,424,424,0
2021-04-01,CH,24,PL07,305263,302857,8697,5952,2745
2021-05-27,RA,17,PL56,219312,218856,480,480,0
2021-12-07,PW,26,PL37,813120,810000,4080,4080,0
2021-11-24,EC,10,PL43,570528,568848,2496,2496,0
2021-05-21,SD,13,PL18,41672,39199,5865,3392,2473
2021-06-25,SB,11,PL50,447296,444160,3808,3808,0
2021-06-26,SD,13,PL17,64872,63683,1842,640,1202
2021-02-16,HO,18,PL01,66136,65640,496,496,0
2021-08-16,CL,14,PL45,293856,287456,1632,1632,0
2021-03-12,CL,14,PL45,302240,287424,2112,2112,0
2021-11-13,CH,24,PL57,29376,29276,100,100,0
2021-01-25,PW,26,PL37,437280,426144,11136,11136,0
2021-06-05,HO,18,PL01,39936,38784,1240,1240,0
2021-01-10,HO,18,PL10,57144,57056,88,88,0
2021-10-08,SB,11,PL36,162336,160608,1728,1728,0
2021-09-02,SD,13,PL17,74694,74504,510,320,190
2021-11-22,PR,15,PL04,266080,265856,576,576,0
2021-01-03,CA,23,PL02,235224,234744,1008,1008,0
2021-08-15,PR,15,PL24,265952,265504,576,576,0
2021-03-05,RT,21,PL42,174256,158800,16064,16064,0
2021-03-14,PW,26,PL37,796608,793680,2928,2928,0
2021-11-25,SB,11,PL50,456608,456064,1216,1216,0
2021-04-08,SD,13,PL25,63100,62851,1081,832,249
2021-03-27,CA,23,PL31,15912,12936,2976,2976,0
2021-04-21,CA,23,PL31,187680,187200,1488,1488,0
2021-04-21,PRG,12,PL14,390080,388928,3456,3456,0
2021-12-10,PR,15,PL24,264896,264992,512,512,0
2021-01-31,SD,13,PL25,62125,61672,645,192,453
2021-08-15,PB,25,PL54,449184,448864,1632,1632,0
2021-02-04,SD,13,PL22,58805,58518,601,192,409
2021-11-29,CA,23,PL02,202992,201888,1320,1320,0
2021-05-10,NT,16,PL51,463968,463072,1568,1568,0
2021-05-13,HO,18,PL03,66808,66648,168,168,0
2021-03-04,RT,21,PL05,173784,172392,1512,1512,0
2021-10-21,CL,14,PL44,301312,299104,1568,1568,0
2021-10-30,CH,24,PL07,233683,222852,15525,4576,10949
2021-04-23,CA,23,PL13,33152,33096,0,0,0
2021-06-14,PW,26,PL37,810576,810240,2112,2112,0
2021-11-29,RT,21,PL42,143280,136768,6512,6512,0
2021-09-15,HO,18,PL01,67288,66936,392,392,0
2021-09-21,RA,17,PL34,197712,192840,4872,4872,0
2021-03-22,CH,24,PL12,163984,163984,192,192,0
2021-01-10,HO,18,PL09,66016,65976,128,128,0
2021-05-01,HO,18,PL32,67568,67312,352,352,0
2021-12-03,RA,17,PL56,225240,224352,1152,1152,0
2021-03-09,SD,13,PL25,73206,73108,293,176,117
2021-05-26,HO,18,PL30,51200,51104,96,96,0
2021-02-25,SD,13,PL25,73262,73309,438,400,38
2021-07-04,SD,13,PL18,59552,58490,1613,384,1229
2021-07-04,CH,24,PL07,229242,216348,16113,2976,13137
2021-08-27,PR,15,PL04,352320,351392,1184,1184,0
2021-10-04,PR,15,PL24,264928,264384,1056,1056,0
2021-11-07,HO,18,PL33,125616,125616,0,0,0
2021-04-12,NT,16,PL51,466368,466976,416,416,0
2021-07-09,PB,25,PL55,443840,443072,1728,1728,0
2021-02-05,PW,26,PL37,807984,794352,14976,14976,0
2021-05-08,RA,17,PL56,221088,220824,264,264,0
2021-06-06,SB,11,PL50,454528,453440,3584,3584,0
2021-12-16,HO,18,PL33,46312,45912,568,568,0
2021-03-21,DI,19,PL52,226816,226016,1088,1088,0
2021-12-08,HO,18,PL09,67280,67000,304,304,0
2021-10-06,PR,15,PL04,263776,263296,704,704,0
2021-11-13,EC,10,PL43,620256,619632,528,528,0
2021-10-24,HO,18,PL03,67288,67152,136,136,0
2021-04-09,HO,18,PL10,57672,57680,0,0,0
2021-09-23,RA,17,PL35,45672,45408,456,456,0
2021-02-07,SD,13,PL22,44921,44844,777,672,105
2021-07-08,PB,25,PL55,442432,438368,4640,4640,0
2021-05-30,RT,21,PL05,209592,209184,696,696,0
2021-02-16,CL,14,PL44,300224,278432,6048,6048,0
2021-08-16,HO,18,PL40,66288,66192,96,96,0
2021-06-15,HO,18,PL01,66496,66304,192,192,0
2021-04-01,CL,14,PL45,0,0,960,960,0
2021-04-22,HO,18,PL10,55992,55888,416,416,0
2021-06-03,SD,13,PL17,7572,7524,111,0,111
2021-08-08,RT,21,PL05,139536,132672,7104,7104,0
2021-12-01,CH,24,PL07,54277,53834,2246,1568,678
2021-12-21,PR,15,PL04,263904,263584,736,736,0
2021-10-12,NT,16,PL51,511424,510816,1344,1344,0
2021-01-03,RA,17,PL34,193416,188160,5256,5256,0
2021-10-23,HO,18,PL40,26152,26152,0,0,0
2021-03-12,SB,11,PL50,433088,429472,4224,4224,0
2021-03-13,HO,18,PL03,66184,66048,136,136,0
2021-04-10,SD,13,PL19,74966,74891,843,768,75
2021-07-26,HO,18,PL09,72392,72320,96,96,0
2021-10-25,RT,21,PL41,172048,167088,5024,5024,0
2021-07-23,PB,25,PL54,437120,434560,3808,3808,0
2021-11-25,CA,23,PL31,163416,162984,768,768,0
2021-06-14,PRG,12,PL14,391648,391296,896,896,0
2021-11-28,DI,19,PL52,280864,279808,1760,1760,0
2021-01-25,HO,18,PL01,63680,63472,352,352,0
2021-03-30,HO,18,PL30,65656,65568,112,112,0
2021-04-09,PR,15,PL04,262400,261216,1664,1664,0
2021-08-23,HO,18,PL11,66288,66288,0,0,0
2021-11-09,SB,11,PL50,371936,369344,5024,5024,0
2021-01-27,SD,13,PL18,56679,55899,3484,2704,780
2021-03-11,SD,13,PL20,74022,73758,1405,1024,381
2021-10-02,SD,13,PL21,59405,59095,1058,720,338
2021-12-18,CH,24,PL07,144421,141607,6024,2080,3944
2021-03-07,CH,24,PL08,195012,192600,21525,15136,6389
2021-12-23,CH,24,PL07,67398,66716,2186,1504,682
2021-04-29,RA,17,PL34,219984,220008,264,264,0
2021-07-07,HO,18,PL10,56512,56464,0,0,0
2021-10-22,HO,18,PL01,67224,65440,1784,1784,0
2021-02-15,PRG,12,PL12,393600,393472,672,672,0
2021-07-09,CL,14,PL45,286368,283264,2880,2880,0
2021-02-18,CA,23,PL02,233592,232896,696,696,0
2021-10-26,RA,17,PL34,196056,179208,16848,16848,0
2021-10-08,CH,24,PL57,34172,34056,116,116,0
2021-04-26,CA,23,PL11,234288,228360,6360,6360,0
2021-06-22,HO,18,PL10,55592,55400,288,288,0
2021-03-22,HO,18,PL01,66192,66080,112,112,0
2021-10-04,PB,25,PL55,443936,443680,2784,2784,0
2021-05-19,PB,25,PL54,104320,97888,20288,20288,0
2021-03-10,HO,18,PL33,68560,68560,0,0,0
2021-06-06,HO,18,PL40,66328,66160,168,168,0
2021-06-28,SD,13,PL22,71748,71406,1110,768,342
2021-04-26,RT,21,PL06,202896,201504,1392,1392,0
2021-10-17,CH,24,PL07,0,0,13621,10240,3381
2021-12-20,RT,21,PL06,206856,206376,624,624,0
2021-06-22,SD,13,PL25,74134,73096,1040,0,1040
2021-05-08,CA,23,PL31,236832,236688,360,360,0
2021-07-13,SD,13,PL22,0,0,794,480,314
2021-05-18,CL,14,PL44,301408,299520,992,992,0
2021-01-02,SD,13,PL18,35485,35238,727,480,247
2021-09-12,HO,18,PL10,68328,68240,88,88,0
2021-06-26,HO,18,PL33,132304,132496,0,0,0
2021-01-17,HO,18,PL10,56808,56680,128,128,0
2021-07-09,HO,18,PL03,65576,65536,224,224,0
2021-08-28,RT,21,PL06,193800,193344,4992,4992,0
2021-12-05,SD,13,PL17,53892,53679,1477,1264,213
2021-01-13,HO,18,PL10,56736,56584,152,152,0
2021-07-15,CA,23,PL31,0,0,1632,1632,0
2021-02-13,CA,23,PL02,235776,235848,528,528,0
2021-02-08,SD,13,PL20,74071,72755,2187,816,1371
2021-05-27,RA,17,PL34,185352,184896,1248,1248,0
2021-03-26,RA,17,PL35,32112,28392,4056,4056,0
2021-01-16,CH,24,PL08,304272,295868,16875,8256,8619
2021-07-06,RT,21,PL05,208200,202392,5952,5952,0
2021-06-26,HO,18,PL10,57128,57008,120,120,0
2021-07-08,RT,21,PL42,178704,175904,3104,3104,0
2021-09-09,CA,23,PL31,235512,235344,384,384,0
2021-03-13,CA,23,PL13,85456,85448,96,96,0
2021-10-18,HO,18,PL11,66192,65808,384,384,0
2021-10-27,CA,23,PL13,63128,63016,112,112,0
2021-01-27,SB,11,PL36,264432,247752,18816,18816,0
2021-02-20,SD,13,PL17,73175,72514,1765,1104,661
2021-03-14,RA,17,PL35,218952,218040,912,912,0
2021-09-01,CA,23,PL31,0,0,0,0,0
2021-11-09,CA,23,PL02,231240,231264,336,336,0
2021-03-14,PB,25,PL55,444288,442976,1728,1728,0
2021-09-12,HO,18,PL01,67360,66880,480,480,0
2021-07-27,RT,21,PL05,146736,146664,2568,2568,0
2021-08-04,HO,18,PL56,64808,63920,888,888,0
2021-09-23,PW,26,PL37,535632,529104,7296,7296,0
2021-03-19,CH,24,PL08,257669,244222,21447,8000,13447
2021-08-17,RT,21,PL41,5344,768,4960,4960,0
2021-12-02,SD,13,PL21,64710,64267,662,208,454
2021-01-15,HO,18,PL10,49656,46624,3032,3032,0
2021-10-20,SD,13,PL18,71147,70645,1030,528,502
2021-05-21,CA,23,PL11,197952,196104,2616,2616,0
2021-08-22,PR,15,PL24,264960,263680,1408,1408,0
2021-08-13,PRG,12,PL14,149728,142624,7104,7104,0
2021-10-23,RT,21,PL41,97328,94672,2656,2656,0
2021-09-20,HO,18,PL11,66304,66304,0,0,0
2021-11-09,RT,21,PL06,204168,203712,720,720,0
2021-08-22,SD,13,PL22,52522,52471,474,384,90
2021-03-10,SD,13,PL17,71639,71360,819,528,291
2021-06-22,PR,15,PL24,264608,264160,736,736,0
2021-05-30,CL,14,PL44,281312,272832,8832,8832,0
2021-07-21,HO,18,PL30,66216,66216,0,0,0
2021-01-15,CA,23,PL02,231360,229776,1584,1584,0
2021-11-19,SB,11,PL50,351328,350752,1632,1632,0
2021-06-10,PR,15,PL24,247072,246592,480,480,0
2021-02-25,CH,24,PL12,53296,52080,1216,1216,0
2021-04-29,HO,18,PL30,66224,66224,0,0,0
2021-07-16,HO,18,PL10,65152,64912,240,240,0
2021-11-09,CA,23,PL13,84800,84856,216,216,0
2021-12-21,DI,19,PL53,294816,292864,2048,2048,0
2021-03-03,NT,16,PL51,397376,397088,1632,1632,0
2021-09-01,HO,18,PL09,69248,68120,1128,1128,0
2021-05-05,CA,23,PL31,166344,164328,2664,2664,0
2021-10-16,DI,19,PL52,245664,244928,1312,1312,0
2021-01-06,RT,21,PL05,172872,172992,1536,1536,0
2021-03-18,PR,15,PL24,265728,265632,480,480,0
2021-05-25,CA,23,PL11,234048,233088,1128,1128,0
2021-02-14,PR,15,PL24,260832,260192,1184,1184,0
2021-03-26,HO,18,PL03,33320,32824,888,888,0
2021-08-08,HO,18,PL11,65488,65352,136,136,0
2021-06-16,HO,18,PL33,132464,132464,0,0,0
2021-09-12,RT,21,PL05,172728,172440,1536,1536,0
2021-02-14,HO,18,PL10,46488,45184,1304,1304,0
2021-01-20,HO,18,PL32,67928,67832,96,96,0
2021-04-13,CH,24,PL08,262495,256348,13348,6848,6500
2021-01-06,EC,10,PL43,154640,152416,2112,2112,0
2021-05-06,DI,19,PL53,267936,268448,1216,1216,0
2021-04-23,SD,13,PL17,72129,71454,1410,736,674
2021-08-29,HO,18,PL03,66776,66688,88,88,0
2021-02-27,RT,21,PL05,206736,206376,600,600,0
2021-11-28,SD,13,PL17,67009,66533,6460,5984,476
2021-11-30,NT,16,PL51,0,0,2976,2976,0
2021-07-14,CA,23,PL02,155184,153720,2064,2064,0
2021-11-12,RA,17,PL35,261336,259656,1920,1920,0
2021-01-22,DI,19,PL53,296288,296768,384,384,0
2021-04-28,PR,15,PL24,261888,260736,1152,1152,0
2021-03-07,HO,18,PL10,17968,17456,512,512,0
2021-02-03,SD,13,PL25,64505,64329,806,544,262
2021-03-13,RA,17,PL35,193776,191760,2280,2280,0
2021-06-21,RT,21,PL41,46464,15120,31344,31344,0
2021-02-24,PR,15,PL24,259232,257632,1792,1792,0
2021-05-10,CA,23,PL02,140856,140712,144,144,0
2021-08-01,CH,24,PL08,181035,179227,14233,6144,8089
2021-12-01,CH,24,PL12,137840,136992,848,848,0
2021-07-08,SB,11,PL50,0,0,3328,3328,0
2021-03-26,PRG,12,PL14,254592,254976,32,32,0
2021-10-31,CH,24,PL24,146448,146320,240,240,0
2021-01-09,PB,25,PL55,380832,284608,103552,103552,0
2021-03-14,DI,19,PL53,294784,295200,320,320,0
2021-04-24,HO,18,PL01,56400,55624,776,776,0
2021-07-18,HO,18,PL01,67800,67712,88,88,0
2021-06-29,HO,18,PL30,65488,65480,112,112,0
2021-10-15,CL,14,PL44,296288,292896,2144,2144,0
2021-05-31,HO,18,PL01,57304,56520,784,784,0
2021-09-16,SD,13,PL21,0,0,1349,864,485
2021-09-25,SD,13,PL25,73272,72003,1813,544,1269
2021-08-15,SD,13,PL20,75899,75899,54,16,38
2021-09-19,RT,21,PL42,189312,188848,1056,1056,0
2021-02-21,CL,14,PL45,301024,278336,1408,1408,0
2021-07-13,HO,18,PL03,63784,63544,392,392,0
2021-03-31,SD,13,PL22,65253,65181,268,176,92
2021-08-19,RT,21,PL05,179928,179424,3000,3000,0
2021-09-05,HO,18,PL01,67432,66968,464,464,0
2021-05-12,RT,21,PL41,0,0,3376,3376,0
2021-11-22,PRG,12,PL12,21760,19072,2688,2688,0
2021-04-15,SD,13,PL17,73398,72575,1557,688,869
2021-01-20,RA,17,PL56,193200,193296,0,0,0
2021-09-29,DI,19,PL52,247648,246560,1440,1440,0
2021-07-30,HO,18,PL03,67592,67544,48,48,0
2021-04-06,PR,15,PL57,7056,7056,5696,5696,0
2021-05-28,PB,25,PL55,441600,438368,4096,4096,0
2021-08-11,PB,25,PL55,329824,238144,91680,91680,0
2021-12-12,HO,18,PL09,66272,66272,0,0,0
2021-02-02,HO,18,PL32,19896,18656,1496,1496,0
2021-04-12,RA,17,PL35,220560,218424,2400,2400,0
2021-10-22,SD,13,PL19,76493,76240,431,176,255
2021-06-02,HO,18,PL40,66336,66336,0,0,0
2021-04-16,CH,24,PL08,295587,285936,12834,2880,9954
2021-02-11,RA,17,PL56,163776,159720,4056,4056,0
2021-06-09,DI,19,PL53,8448,8416,32,32,0
2021-10-14,HO,18,PL30,0,0,5392,5392,0
2021-07-22,PB,25,PL54,442560,441152,1920,1920,0
2021-11-23,HO,18,PL09,47984,47816,216,216,0
2021-06-15,CL,14,PL45,293920,289632,3616,3616,0
2021-09-06,PB,25,PL55,60992,53312,7840,7840,0
2021-09-28,HO,18,PL40,66288,66288,0,0,0
2021-02-12,HO,18,PL30,66160,66160,0,0,0
2021-09-29,CA,23,PL31,130896,127752,3168,3168,0
2021-06-05,HO,18,PL03,14648,14200,448,448,0
2021-11-04,CH,24,PL57,34108,34064,44,44,0
2021-08-30,CH,24,PL08,302002,298085,13415,9376,4039
2021-10-17,PB,25,PL55,284352,283392,1248,1248,0
2021-02-02,SD,13,PL25,72738,72477,453,192,261
2021-05-05,SD,13,PL20,54001,53961,4083,3936,147
2021-06-23,CA,23,PL31,231072,230880,480,480,0
2021-06-04,SD,13,PL21,74625,74042,922,352,570
2021-10-10,PRG,12,PL14,390240,389632,896,896,0
2021-03-17,SD,13,PL19,71976,70983,2512,1424,1088
2021-06-19,HO,18,PL30,66200,66112,88,88,0
2021-06-27,SD,13,PL19,75030,74965,513,400,113
2021-07-31,HO,18,PL40,66128,65176,952,952,0
2021-10-13,CL,14,PL45,0,0,3840,3840,0
2021-03-29,CL,14,PL45,297216,292512,2368,2368,0
2021-04-29,PR,15,PL57,138640,136960,1760,1760,0
2021-04-08,SD,13,PL17,40074,39837,1359,960,399
2021-02-19,CL,14,PL45,300736,276992,2464,2464,0
2021-06-09,RA,17,PL34,166056,165936,2760,2760,0
2021-11-09,SD,13,PL17,63728,63407,686,352,334
2021-01-22,NT,16,PL51,0,0,32,32,0
2021-06-07,SD,13,PL22,42062,41575,7447,6960,487
2021-06-13,PB,25,PL55,449632,444096,6048,6048,0
2021-09-01,HO,18,PL11,66208,66280,0,0,0
2021-11-06,CH,24,PL24,111968,112016,800,800,0
2021-10-13,RT,21,PL42,33312,31216,2096,2096,0
2021-07-03,HO,18,PL30,66224,66224,0,0,0
2021-06-11,RT,21,PL05,134976,131232,3744,3744,0
2021-02-22,CA,23,PL02,234648,234696,288,288,0
2021-11-16,PW,26,PL37,812112,811872,1440,1440,0
2021-10-15,CH,24,PL08,301916,295651,17917,11584,6333
2021-01-12,CL,14,PL44,265824,256960,4512,4512,0
2021-04-15,RA,17,PL35,193272,190128,3144,3144,0
2021-05-10,CA,23,PL13,85016,85016,112,112,0
2021-07-01,HO,18,PL03,66768,66664,200,200,0
2021-06-30,CL,14,PL45,297920,294304,2944,2944,0
2021-01-13,DI,19,PL52,295520,295360,672,672,0
2021-09-30,RA,17,PL35,239400,225000,14400,14400,0
2021-10-12,PRG,12,PL14,385440,385248,928,928,0
2021-02-03,PR,15,PL24,134752,133952,800,800,0
2021-08-27,SD,13,PL25,72815,72433,1250,848,402
2021-12-10,CH,24,PL08,264516,255691,16857,8032,8825
2021-04-13,CH,24,PL12,134640,134160,1088,1088,0
2021-11-04,RA,17,PL34,51264,22824,28584,28584,0
2021-03-08,CH,24,PL12,162304,161664,1424,1424,0
2021-05-31,CH,24,PL57,34144,34112,48,48,0
2021-08-19,HO,18,PL03,59432,59432,136,136,0
2021-09-26,CL,14,PL44,295776,293408,2048,2048,0
2021-03-18,DI,19,PL53,252000,250720,1472,1472,0
2021-11-20,EC,10,PL43,624624,624192,576,576,0
2021-02-02,CA,23,PL13,84808,84184,704,704,0
2021-03-23,HO,18,PL01,65192,64608,584,584,0
2021-11-05,PB,25,PL54,380416,356896,23584,23584,0
2021-09-15,HO,18,PL10,68280,68192,184,184,0
2021-11-23,RT,21,PL05,185280,182088,3408,3408,0
2021-11-24,DI,19,PL52,279872,275616,4992,4992,0
2021-03-16,HO,18,PL32,63144,62744,400,400,0
2021-04-15,PR,15,PL04,260128,258848,1280,1280,0
2021-12-07,CH,24,PL08,240186,237628,4664,1984,2680
2021-01-27,HO,18,PL01,66272,66224,56,56,0
2021-02-14,RT,21,PL42,190800,185888,5072,5072,0
2021-12-09,RA,17,PL34,36480,35424,3864,3864,0
2021-01-12,SD,13,PL25,72773,72331,618,176,442
2021-08-06,PB,25,PL54,307264,287072,21504,21504,0
2021-06-04,RA,17,PL56,218952,217392,1728,1728,0
2021-04-26,CA,23,PL31,164400,164136,1176,1176,0
2021-04-06,SD,13,PL20,61529,61264,4603,4336,267
2021-10-20,CH,24,PL12,163328,163136,192,192,0
2021-07-14,HO,18,PL01,53024,52504,776,776,0
2021-02-03,SD,13,PL18,69640,68850,982,192,790
2021-07-23,SD,13,PL20,69744,69679,801,736,65
2021-10-18,CA,23,PL13,84680,84624,272,272,0
2021-01-28,PW,26,PL37,813408,810432,4560,4560,0
2021-01-28,HO,18,PL32,67096,64520,2576,2576,0
2021-10-23,RT,21,PL06,205752,204384,1368,1368,0
2021-08-02,CH,24,PL57,22880,22816,100,100,0
2021-02-21,HO,18,PL10,57280,57192,88,88,0
2021-10-19,CH,24,PL12,164640,164480,192,192,0
2021-09-02,HO,18,PL56,62536,62360,240,240,0
2021-04-11,CA,23,PL31,2472,0,2472,2472,0
2021-01-15,PRG,12,PL14,385024,385280,896,896,0
2021-12-15,PR,15,PL04,263488,261472,2368,2368,0
2021-10-29,EC,10,PL43,188496,185904,2544,2544,0
2021-04-28,SD,13,PL17,66330,65962,816,448,368
2021-01-10,SD,13,PL19,58431,58188,1827,1584,243
2021-06-09,DI,19,PL52,290656,289216,1472,1472,0
2021-08-17,CL,14,PL44,2944,2880,28224,28224,0
2021-11-15,PRG,12,PL14,390080,389632,1120,1120,0
2021-03-08,NT,16,PL57,123744,123664,768,768,0
2021-07-19,RT,21,PL41,38400,27584,16416,16416,0
2021-11-04,SD,13,PL19,75258,75127,515,384,131
2021-06-17,SD,13,PL25,46798,46293,1791,944,847
2021-08-14,HO,18,PL33,57272,56760,512,512,0
2021-12-17,SD,13,PL22,73409,73290,1191,1072,119
2021-09-10,PB,25,PL54,426752,419712,10752,10752,0
2021-02-26,SB,11,PL50,214624,191200,23424,23424,0
2021-09-24,HO,18,PL01,67712,67536,224,224,0
2021-03-14,SD,13,PL22,72772,72587,582,352,230
2021-06-09,PR,15,PL12,119984,119840,144,144,0
2021-01-25,RA,17,PL34,189768,183480,6528,6528,0
2021-07-24,PRG,12,PL14,183680,182240,1440,1440,0
2021-01-11,SD,13,PL25,51611,51391,4004,3728,276
2021-06-08,DI,19,PL52,244384,242208,2560,2560,0
2021-07-24,RT,21,PL41,0,0,0,0,0
2021-11-06,HO,18,PL11,65688,64864,824,824,0
2021-02-14,HO,18,PL09,72680,72648,80,80,0
2021-06-12,RT,21,PL05,116376,106440,10200,10200,0
2021-09-06,PB,25,PL54,448160,447648,1600,1600,0
2021-07-02,EC,10,PL43,598560,596256,2688,2688,0
2021-11-22,SD,13,PL21,64257,63913,783,368,415
2021-11-03,PW,26,PL37,811776,807264,7344,7344,0
2021-12-11,HO,18,PL11,66288,66288,0,0,0
2021-01-12,DI,19,PL53,24544,23840,4128,4128,0
2021-01-13,PR,15,PL04,260576,259776,896,896,0
2021-05-26,HO,18,PL10,56952,56744,232,232,0
2021-09-15,SD,13,PL19,74083,73972,495,384,111
2021-10-07,HO,18,PL30,0,0,896,896,0
2021-09-09,CA,23,PL02,227760,226128,1752,1752,0
2021-11-22,RA,17,PL34,257520,254616,2904,2904,0
2021-05-22,CA,23,PL11,210072,207960,2544,2544,0
2021-06-10,HO,18,PL33,98064,97008,1104,1104,0
2021-06-02,HO,18,PL33,130096,130064,256,256,0
2021-05-17,SD,13,PL21,73267,72497,1985,192,1793
2021-05-27,RA,17,PL35,217728,212640,5928,5928,0
2021-03-11,RT,21,PL05,183312,182472,1008,1008,0
2021-05-12,HO,18,PL32,65112,65064,104,104,0
2021-02-17,CA,23,PL02,193992,181320,13368,13368,0
2021-06-15,CL,14,PL44,296896,292640,3904,3904,0
2021-07-05,PB,25,PL55,443936,443328,1792,1792,0
2021-07-02,RA,17,PL34,129048,129048,9696,9696,0
2021-08-03,CA,23,PL31,233352,231864,1656,1656,0
2021-08-09,SD,13,PL19,68003,67759,2513,2256,257
2021-04-27,HO,18,PL03,66296,66272,24,24,0
2021-05-18,SD,13,PL18,69492,68942,742,192,550
2021-09-30,CL,14,PL44,151616,117408,19104,19104,0
2021-11-18,CA,23,PL02,230880,229872,624,624,0
2021-10-02,CH,24,PL08,295667,291865,12528,8704,3824
2021-04-12,RT,21,PL05,208560,208224,288,288,0
2021-08-16,HO,18,PL03,66896,66816,120,120,0
2021-04-08,PRG,12,PL14,389120,388416,1024,1024,0
2021-05-16,SD,13,PL17,66699,65544,1375,176,1199
2021-04-12,PR,15,PL04,262144,261824,704,704,0
2021-11-03,PR,15,PL04,0,0,65120,65120,0
2021-04-14,SD,13,PL20,55604,54364,2440,1200,1240
2021-07-07,HO,18,PL09,70960,70936,184,184,0
2021-11-10,HO,18,PL56,62576,62392,184,184,0
2021-03-26,SD,13,PL20,65029,64662,751,384,367
2021-09-01,SD,13,PL25,61904,60546,3230,1872,1358
2021-06-27,NT,16,PL51,511904,511424,1120,1120,0
2021-09-30,PW,26,PL37,816432,816288,1536,1536,0
2021-12-21,RT,21,PL05,209376,207408,1968,1968,0
2021-02-19,HO,18,PL11,66288,66288,0,0,0
2021-02-13,HO,18,PL30,66160,66160,0,0,0
2021-03-29,NT,16,PL51,469632,467712,3072,3072,0
2021-03-25,HO,18,PL11,64896,64640,360,360,0
2021-11-17,CH,24,PL57,34288,34212,92,92,0
2021-02-23,CL,14,PL45,299872,276640,2080,2080,0
2021-07-16,HO,18,PL03,65552,64280,1272,1272,0
2021-01-26,HO,18,PL32,66696,66608,88,88,0
2021-01-09,SB,11,PL50,246272,245344,2080,2080,0
2021-03-11,SD,13,PL25,74465,74502,198,176,22
2021-10-31,HO,18,PL09,64912,64800,160,160,0
2021-06-28,CA,23,PL11,233160,233136,360,360,0
2021-10-26,CL,14,PL44,299648,296384,2944,2944,0
2021-08-18,HO,18,PL03,0,0,0,0,0
2021-01-21,SD,13,PL21,22162,19439,8701,5968,2733
2021-02-06,HO,18,PL11,65344,65224,120,120,0
2021-09-09,HO,18,PL30,5392,5392,1968,1968,0
2021-03-03,CA,23,PL13,78288,78232,184,184,0
2021-11-25,EC,10,PL43,626592,623328,3216,3216,0
2021-06-29,SD,13,PL21,56576,56048,1320,784,536
2021-12-18,SD,13,PL17,70415,69251,1548,384,1164
2021-04-24,SD,13,PL20,64768,64688,1526,1360,166
2021-09-28,DI,19,PL53,295968,296096,352,352,0
2021-02-07,CH,24,PL08,111584,104955,18420,9664,8756
2021-07-11,CA,23,PL31,199128,197136,2208,2208,0
2021-04-22,RT,21,PL06,199608,193992,5928,5928,0
2021-01-17,SD,13,PL22,70656,69848,984,176,808
2021-04-25,CA,23,PL13,75968,75760,256,256,0
2021-02-10,PR,15,PL24,267744,266912,960,960,0
2021-06-14,CH,24,PL07,283051,275467,13602,5824,7778
2021-03-22,CL,14,PL45,301280,287904,2400,2400,0
2021-05-10,SD,13,PL21,73181,72750,685,176,509
2021-06-18,CL,14,PL45,277920,269824,7200,7200,0
2021-09-19,CA,23,PL13,85320,85168,256,256,0
2021-05-10,CA,23,PL11,228360,226344,2784,2784,0
2021-01-09,SD,13,PL21,68671,67659,1275,176,1099
2021-02-06,HO,18,PL01,65264,64720,544,544,0
2021-10-04,DI,19,PL53,294560,294688,640,640,0
2021-10-25,DI,19,PL52,129728,122016,7744,7744,0
2021-12-14,HO,18,PL10,68616,68520,96,96,0
2021-04-17,SB,11,PL50,358880,358528,1632,1632,0
2021-05-18,SB,11,PL36,311880,308856,3024,3024,0
2021-02-11,PR,15,PL57,142432,142352,192,192,0
2021-04-09,CA,23,PL02,233256,231432,2040,2040,0
2021-01-26,HO,18,PL33,68712,68712,0,0,0
2021-01-07,PRG,12,PL14,390784,390880,1024,1024,0
2021-05-26,PW,26,PL37,794496,792528,3408,3408,0
2021-01-26,HO,18,PL10,37456,36088,1496,1496,0
2021-03-15,CH,24,PL08,282903,281243,8636,6976,1660
2021-10-13,RT,21,PL05,209448,209688,24,24,0
2021-05-03,SD,13,PL25,73683,73401,285,0,285
2021-06-08,CA,23,PL11,209448,208656,1032,1032,0
2021-10-31,CH,24,PL57,34200,34200,48,48,0
2021-04-06,RA,17,PL34,156960,156648,2928,2928,0
2021-04-26,PB,25,PL54,428256,423392,6080,6080,0
2021-03-06,HO,18,PL32,38728,38192,536,536,0
2021-06-24,SD,13,PL22,70590,69071,2171,384,1787
2021-01-24,SD,13,PL17,72576,72196,801,368,433
2021-03-19,SD,13,PL22,58110,57978,834,592,242
2021-11-24,NT,16,PL51,502176,501760,1440,1440,0
2021-12-10,RA,17,PL56,192720,192000,4320,4320,0
2021-02-04,CA,23,PL13,61496,60848,648,648,0
2021-10-15,CA,23,PL02,205848,203736,2160,2160,0
2021-03-05,HO,18,PL33,68464,68536,0,0,0
2021-06-15,DI,19,PL52,287968,286176,2304,2304,0
2021-06-30,CA,23,PL02,216504,216000,912,912,0
2021-03-13,NT,16,PL51,445568,443680,2496,2496,0
2021-04-29,RA,17,PL56,218616,217872,864,864,0
2021-03-29,CH,24,PL08,221412,219545,8430,6272,2158
2021-09-03,SB,11,PL50,399392,397760,2400,2400,0
2021-01-05,SD,13,PL17,61386,61371,289,224,65
2021-02-11,SB,11,PL50,4032,4032,0,0,0
2021-06-11,CH,24,PL07,145712,144504,8502,4288,4214
2021-06-13,CH,24,PL07,297555,288257,18985,9312,9673
2021-03-28,DI,19,PL52,295776,295456,1216,1216,0
2021-10-29,CA,23,PL13,0,0,208,208,0
2021-06-05,RA,17,PL56,222552,222264,288,288,0
2021-06-25,SD,13,PL21,71373,70930,1556,1072,484
2021-04-29,SD,13,PL17,56894,56474,1381,912,469
2021-03-06,RT,21,PL05,209904,209904,0,0,0
2021-10-27,CA,23,PL31,0,0,5736,5736,0
2021-03-17,HO,18,PL09,70504,69680,824,824,0
2021-07-30,HO,18,PL33,65016,64360,720,720,0
2021-01-27,CH,24,PL08,86071,83040,7511,4480,3031
2021-11-26,SD,13,PL19,64718,64621,314,192,122
2021-08-25,CH,24,PL07,171529,168950,22003,19424,2579
2021-08-17,RT,21,PL42,52272,50160,2848,2848,0
2021-03-10,PW,26,PL37,630336,613920,17712,17712,0
2021-11-27,HO,18,PL01,67272,66736,608,608,0
2021-01-11,CH,24,PL57,34260,34264,44,44,0
2021-06-16,PB,25,PL55,449952,448800,1632,1632,0
2021-08-08,PRG,12,PL14,255296,235520,19776,19776,0
2021-12-20,HO,18,PL32,57584,57496,96,96,0
2021-07-15,RT,21,PL42,184432,181120,3488,3488,0
2021-11-12,RT,21,PL41,165536,158704,6896,6896,0
2021-05-26,CA,23,PL31,200688,198624,2328,2328,0
2021-09-19,EC,10,PL43,629136,628368,720,720,0
2021-03-17,CA,23,PL31,201624,199920,2184,2184,0
2021-09-15,PB,25,PL54,0,0,10368,10368,0
2021-09-28,HO,18,PL10,288,184,0,0,0
2021-10-04,HO,18,PL33,129904,129840,240,240,0
2021-06-28,SD,13,PL20,65653,64821,1376,544,832
2021-05-26,CA,23,PL13,84576,84712,120,120,0
2021-08-28,SD,13,PL22,76501,76428,249,176,73
2021-09-07,HO,18,PL56,66088,65992,136,136,0
2021-04-08,HO,18,PL09,41904,41704,800,800,0
2021-12-10,HO,18,PL10,68416,68368,104,104,0
2021-05-26,RT,21,PL41,23600,0,23600,23600,0
2021-01-21,SD,13,PL20,74450,74401,967,832,135
2021-03-27,HO,18,PL01,62112,62000,112,112,0
2021-01-08,SD,13,PL20,74545,73450,1495,400,1095
2021-10-28,SD,13,PL22,73475,73383,1068,976,92
2021-11-23,EC,10,PL43,631296,631152,864,864,0
2021-09-23,SD,13,PL22,61969,61912,1324,1232,92
2021-05-31,HO,18,PL03,66808,66624,184,184,0
2021-06-05,CL,14,PL44,52416,51392,1312,1312,0
2021-06-10,PRG,12,PL14,390560,390176,928,928,0
2021-12-01,CL,14,PL45,294048,290720,2144,2144,0
2021-01-19,HO,18,PL30,63896,63640,360,360,0
2021-03-17,SB,11,PL50,251296,248960,9696,9696,0
2021-03-24,HO,18,PL11,66288,66288,0,0,0
2021-07-01,DI,19,PL52,253664,252384,2976,2976,0
2021-04-12,RT,21,PL06,209544,209136,744,744,0
2021-07-07,CL,14,PL45,120672,87360,30176,30176,0
2021-10-11,PR,15,PL04,247648,232960,15264,15264,0
2021-03-30,SD,13,PL18,64783,62686,2881,784,2097
2021-02-17,HO,18,PL32,60032,59704,536,536,0
2021-03-17,SD,13,PL21,45867,43491,5592,3104,2488
2021-08-07,SD,13,PL19,35512,35283,405,176,229
2021-11-16,RT,21,PL06,205128,204576,816,816,0
2021-03-11,CA,23,PL13,85344,85320,88,88,0
2021-07-19,PB,25,PL54,442496,441824,2144,2144,0
2021-12-20,SB,11,PL36,298392,294840,4272,4272,0
2021-02-15,SD,13,PL20,75881,75523,775,384,391
2021-01-21,EC,10,PL43,580272,565104,15312,15312,0
2021-03-22,SD,13,PL21,69882,69405,2539,2048,491
2021-10-12,SD,13,PL25,57516,56731,8494,7696,798
2021-02-09,CH,24,PL04,137008,136608,976,976,0
2021-10-15,CA,23,PL31,188304,182760,6168,6168,0
2021-04-28,HO,18,PL03,66296,66296,0,0,0
2021-06-24,CA,23,PL02,234288,232128,2328,2328,0
2021-08-22,HO,18,PL01,67056,65616,1440,1440,0
2021-10-26,HO,18,PL09,68360,68224,136,136,0
2021-12-22,EC,10,PL43,628464,627744,576,576,0
2021-11-06,RA,17,PL34,255984,252048,4368,4368,0
2021-04-23,NT,16,PL51,385952,384640,1312,1312,0
2021-11-25,CL,14,PL45,294592,289312,2496,2496,0
2021-01-28,HO,18,PL01,11408,11360,528,528,0
2021-12-16,HO,18,PL11,62248,61688,560,560,0
2021-05-21,DI,19,PL52,255296,242528,12960,12960,0
2021-09-03,SD,13,PL17,75371,75169,435,176,259
2021-11-16,HO,18,PL32,57656,57656,0,0,0
2021-02-14,RA,17,PL56,221592,220368,1368,1368,0
2021-04-30,CA,23,PL31,178896,174408,4728,4728,0
2021-05-10,SD,13,PL18,74368,74230,330,192,138
2021-02-25,CL,14,PL45,300864,287776,2048,2048,0
2021-02-01,PRG,12,PL14,324544,323872,1120,1120,0
2021-05-05,PR,15,PL57,16048,16048,0,0,0
2021-05-20,HO,18,PL03,66744,66648,160,160,0
2021-02-06,SB,11,PL36,301152,297504,3936,3936,0
2021-03-05,SD,13,PL20,62812,62570,1362,1120,242
2021-07-05,HO,18,PL03,66768,66584,248,248,0
2021-10-08,SD,13,PL25,75640,75313,887,544,343
2021-11-04,CA,23,PL31,0,0,1008,1008,0
2021-02-22,RT,21,PL41,41728,28304,13424,13424,0
2021-01-29,DI,19,PL53,298944,299360,0,0,0
2021-10-27,SD,13,PL25,71380,70666,1115,480,635
2021-07-19,PRG,12,PL14,388320,387264,1472,1472,0
2021-12-01,CH,24,PL24,122192,121680,1024,1024,0
2021-10-26,RA,17,PL35,161808,151776,13872,13872,0
2021-12-15,HO,18,PL10,68864,68608,256,256,0
2021-01-20,HO,18,PL10,57384,57384,0,0,0
2021-09-09,SD,13,PL21,74622,74264,958,592,366
2021-09-27,SB,11,PL50,366912,360000,7296,7296,0
2021-03-18,RA,17,PL35,209760,209472,288,288,0
2021-09-07,HO,18,PL40,66120,65992,128,128,0
2021-10-13,PB,25,PL54,450432,447616,3168,3168,0
2021-03-25,CA,23,PL31,230376,228504,2088,2088,0
2021-12-18,SB,11,PL36,291840,289536,2976,2976,0
2021-05-15,CA,23,PL31,216600,201168,16056,16056,0
2021-08-10,EC,10,PL43,636576,636528,624,624,0
2021-08-15,PRG,12,PL14,392672,392352,1344,1344,0
2021-03-17,SD,13,PL22,70087,69963,1512,1312,200
2021-06-23,DI,19,PL53,297760,296000,1984,1984,0
2021-09-16,PW,26,PL37,285552,284928,20688,20688,0
2021-06-22,RT,21,PL42,179808,171728,8112,8112,0
2021-08-14,HO,18,PL03,66848,66760,88,88,0
2021-01-17,CA,23,PL31,35184,34176,4248,4248,0
2021-02-14,PW,26,PL37,814416,812400,3168,3168,0
2021-06-17,HO,18,PL10,57728,57728,0,0,0
2021-04-10,HO,18,PL09,65576,65184,392,392,0
2021-10-04,NT,16,PL51,512256,510880,1568,1568,0
2021-04-29,SD,13,PL21,71729,71361,1024,560,464
2021-05-16,PB,25,PL55,405792,405632,1280,1280,0
2021-09-07,HO,18,PL33,91408,90736,672,672,0
2021-02-21,PRG,12,PL12,354304,340288,14496,14496,0
2021-05-29,CH,24,PL57,24480,24384,96,96,0
2021-03-25,SD,13,PL20,68888,68573,774,368,406
2021-03-08,SD,13,PL19,59678,58357,1705,384,1321
2021-05-05,DI,19,PL52,266208,266112,1312,1312,0
2021-04-05,HO,18,PL33,66144,66184,0,0,0
2021-05-25,SD,13,PL20,66784,66612,3713,3520,193
2021-05-23,CA,23,PL11,13488,12264,1224,1224,0
2021-07-04,HO,18,PL01,66576,66160,416,416,0
2021-02-23,RT,21,PL42,187504,184832,2768,2768,0
2021-06-19,CA,23,PL31,104472,103056,1416,1416,0
2021-10-16,CH,24,PL07,0,0,8502,3232,5270
2021-05-21,PB,25,PL55,295488,273632,31008,31008,0
2021-07-19,HO,18,PL03,47480,45320,2264,2264,0
2021-12-03,CL,14,PL45,269728,266272,2912,2912,0
2021-12-07,HO,18,PL11,50312,50312,0,0,0
2021-03-11,CH,24,PL12,159152,158464,1008,1008,0
2021-03-06,RT,21,PL06,205584,205464,360,360,0
2021-11-30,CH,24,PL12,164480,164480,192,192,0
2021-06-10,CL,14,PL44,298912,293568,4384,4384,0
2021-09-12,DI,19,PL53,295296,294400,1056,1056,0
2021-03-16,HO,18,PL10,56864,56832,88,88,0
2021-04-25,SD,13,PL19,73965,73908,2043,2000,43
2021-07-30,HO,18,PL30,0,0,144,144,0
2021-11-01,SD,13,PL22,75836,75721,499,384,115
2021-04-12,SD,13,PL21,49289,49090,743,416,327
2021-09-17,HO,18,PL56,65360,64488,936,936,0
2021-08-05,HO,18,PL33,62880,62840,304,304,0
2021-06-04,RA,17,PL34,222816,222960,0,0,0
2021-05-20,RT,21,PL05,125280,121560,3840,3840,0
2021-11-26,PB,25,PL55,297696,280256,18816,18816,0
2021-03-04,NT,16,PL51,472096,471520,1216,1216,0
2021-06-23,CL,14,PL44,298880,296736,1568,1568,0
2021-02-15,HO,18,PL32,67616,67544,200,200,0
2021-03-14,HO,18,PL01,65552,65200,352,352,0
2021-11-24,HO,18,PL32,57080,57032,120,120,0
2021-05-06,DI,19,PL52,283392,281280,3072,3072,0
2021-07-28,RT,21,PL42,96064,94704,2192,2192,0
2021-06-27,SB,11,PL36,304056,299424,5592,5592,0
2021-12-04,SD,13,PL19,60965,60356,893,208,685
2021-10-21,PW,26,PL37,800112,796608,4320,4320,0
2021-10-27,SD,13,PL18,75965,75572,691,208,483
2021-05-03,CA,23,PL13,85208,85224,112,112,0
2021-11-13,SD,13,PL18,67775,66622,1592,368,1224
2021-05-31,SD,13,PL17,66938,66400,1446,816,630
2021-11-14,PB,25,PL54,448160,438400,10592,10592,0
2021-12-13,PB,25,PL55,448768,448544,960,960,0
2021-06-04,HO,18,PL33,132288,131760,528,528,0
2021-02-16,HO,18,PL09,72520,72432,88,88,0
2021-07-13,CA,23,PL31,0,0,3792,3792,0
2021-01-05,CH,24,PL57,33040,32044,1076,1076,0
2021-11-10,CH,24,PL07,150235,145776,14387,4768,9619
2021-06-09,CA,23,PL11,178560,176808,1752,1752,0
2021-11-01,SD,13,PL17,60060,59864,2040,1776,264
2021-09-17,NT,16,PL51,494752,474048,21408,21408,0
2021-11-21,CH,24,PL57,20280,20276,4,4,0
2021-04-16,RT,21,PL05,205368,205416,336,336,0
2021-05-26,RA,17,PL34,198000,193176,5232,5232,0
2021-03-26,RT,21,PL42,44912,44096,816,816,0
2021-12-03,SD,13,PL17,59730,59446,720,416,304
2021-03-09,DI,19,PL53,286848,286496,448,448,0
2021-09-06,HO,18,PL10,67696,67680,96,96,0
2021-10-20,SD,13,PL19,534,532,6,0,6
2021-09-21,HO,18,PL32,57080,57016,96,96,0
2021-08-29,SD,13,PL25,30008,29345,1399,736,663
2021-09-17,RA,17,PL35,218208,215664,2808,2808,0
2021-01-28,EC,10,PL43,609984,608880,1776,1776,0
2021-01-26,CL,14,PL45,104416,99744,0,0,0
2021-07-23,PRG,12,PL14,105344,93376,12320,12320,0
2021-02-27,DI,19,PL53,298816,299200,0,0,0
2021-10-27,HO,18,PL30,7696,5952,3488,3488,0
2021-12-18,HO,18,PL09,66224,66112,112,112,0
2021-09-10,HO,18,PL11,65304,65136,168,168,0
2021-05-27,SB,11,PL50,390240,388160,5216,5216,0
2021-08-22,HO,18,PL10,69232,69200,32,32,0
2021-08-13,CA,23,PL31,0,0,3816,3816,0
2021-09-15,CL,14,PL45,223584,210304,9856,9856,0
2021-01-30,SD,13,PL20,42,0,42,0,42
2021-03-27,PW,26,PL37,742176,731664,14448,14448,0
2021-10-09,RT,21,PL05,207408,207096,312,312,0
2021-11-06,DI,19,PL52,295168,294496,864,864,0
2021-12-20,SD,13,PL22,73990,73850,2764,2624,140
2021-02-14,CH,24,PL08,238816,230528,8320,8320,0
2021-09-10,HO,18,PL01,65512,64520,1064,1064,0
2021-10-15,SD,13,PL22,28436,26167,20382,18112,2270
2021-08-08,CH,24,PL07,95638,67360,33782,5504,28278
2021-08-30,SD,13,PL18,3994,3921,99,16,83
2021-03-22,CL,14,PL44,305280,299616,512,512,0
2021-06-05,HO,18,PL09,70992,70784,232,232,0
2021-11-18,SD,13,PL18,49189,48807,4830,4448,382
2021-04-11,NT,16,PL51,457984,455424,2976,2976,0
2021-12-12,CH,24,PL12,163968,164048,208,208,0
2021-10-06,SD,13,PL18,69942,68918,1652,624,1028
2021-03-16,HO,18,PL33,136,48,88,88,0
2021-10-28,HO,18,PL32,57280,57192,88,88,0
2021-07-10,HO,18,PL32,67832,67736,96,96,0
2021-06-17,CL,14,PL44,299456,296256,3040,3040,0
2021-09-06,CH,24,PL07,278588,264531,26080,11648,14432
2021-03-07,PRG,12,PL14,367904,339712,28128,28128,0
2021-04-14,SD,13,PL22,74850,74808,301,192,109
2021-09-29,SD,13,PL20,75818,75749,437,368,69
2021-12-06,SB,11,PL50,453088,451680,1600,1600,0
2021-06-14,HO,18,PL40,65704,65576,128,128,0
2021-02-26,DI,19,PL53,272448,272096,1440,1440,0
2021-08-04,PR,15,PL12,138976,138880,176,176,0
2021-10-09,SD,13,PL25,75858,75534,762,368,394
2021-08-08,SD,13,PL17,46170,37929,8547,240,8307
2021-03-03,HO,18,PL10,26888,26288,600,600,0
2021-10-15,CH,24,PL12,163536,163504,224,224,0
2021-04-10,HO,18,PL01,66152,66120,96,96,0
2021-12-04,CH,24,PL07,136453,134786,5794,3648,2146
2021-04-24,HO,18,PL30,52128,51392,736,736,0
2021-09-11,CH,24,PL12,163056,161808,1936,1936,0
2021-07-30,PR,15,PL12,138592,138400,336,336,0
2021-11-06,SD,13,PL21,55844,55684,608,448,160
2021-06-11,HO,18,PL09,71712,71616,96,96,0
2021-07-18,HO,18,PL32,68592,68592,0,0,0
2021-10-07,SD,13,PL20,71132,70685,1086,544,542
2021-08-01,PB,25,PL54,444448,443168,2368,2368,0
2021-07-23,HO,18,PL03,67120,67056,96,96,0
2021-09-07,EC,10,PL43,245616,236688,8688,8688,0
2021-10-17,CH,24,PL12,164128,163952,240,240,0
2021-09-04,SD,13,PL17,20459,20329,2287,2144,143
2021-12-09,HO,18,PL33,38848,37576,1272,1272,0
2021-04-23,CH,24,PL12,154256,153616,992,992,0
2021-10-07,CL,14,PL44,297376,286176,2208,2208,0
2021-03-14,HO,18,PL10,57032,56904,128,128,0
2021-02-05,SD,13,PL25,62527,62210,4130,3728,402
2021-11-15,RT,21,PL42,149584,143808,12928,12928,0
2021-04-29,NT,16,PL51,456576,456448,864,864,0
2021-11-17,HO,18,PL30,0,0,1616,1616,0
2021-01-12,RA,17,PL34,169416,167256,5208,5208,0
2021-12-03,PB,25,PL55,446688,446688,2048,2048,0
2021-04-30,CH,24,PL07,289276,269361,42491,21632,20859
2021-04-09,RA,17,PL35,190872,188976,3168,3168,0
2021-09-08,HO,18,PL03,19296,18584,712,712,0
2021-04-01,CA,23,PL31,224256,217728,6648,6648,0
2021-03-25,RA,17,PL56,174216,169056,5184,5184,0
2021-03-21,PR,15,PL24,267904,267552,544,544,0
2021-11-17,CH,24,PL24,109664,108672,1120,1120,0
2021-12-01,HO,18,PL01,38944,37080,1864,1864,0
2021-06-19,HO,18,PL01,67160,66920,240,240,0
2021-06-11,HO,18,PL32,68584,68584,0,0,0
2021-03-02,HO,18,PL30,5080,4216,864,864,0
2021-09-10,DI,19,PL53,292032,292224,352,352,0
2021-05-30,PB,25,PL55,444640,443264,2880,2880,0
2021-03-21,RA,17,PL56,218640,216840,1968,1968,0
2021-04-26,CL,14,PL45,0,0,0,0,0
2021-01-24,RA,17,PL35,221112,220728,720,720,0
2021-10-07,PB,25,PL54,101856,86112,23488,23488,0
2021-12-07,SD,13,PL22,76210,75987,591,368,223
2021-10-31,CL,14,PL45,296128,293056,2880,2880,0
2021-02-13,NT,16,PL51,377600,371232,7072,7072,0
2021-11-14,SD,13,PL22,70614,70545,2635,2544,91
2021-09-07,CA,23,PL13,84808,84808,96,96,0
2021-10-21,HO,18,PL56,65984,65768,216,216,0
2021-05-30,DI,19,PL52,289120,286656,2720,2720,0
2021-04-20,CH,24,PL08,291965,282965,12714,3712,9002
2021-07-02,RT,21,PL42,188112,186304,1984,1984,0
2021-11-19,PB,25,PL54,447200,439424,8096,8096,0
2021-12-04,EC,10,PL43,606624,606576,960,960,0
2021-02-24,HO,18,PL32,67744,67312,512,512,0
2021-06-24,RT,21,PL05,172128,171696,984,984,0
2021-04-01,CA,23,PL02,235416,235512,312,312,0
2021-05-02,CH,24,PL12,41024,38144,2880,2880,0
2021-12-06,SD,13,PL18,49067,48450,2021,1216,805
2021-01-07,HO,18,PL01,65448,63880,1568,1568,0
2021-02-28,RT,21,PL06,205272,204792,624,624,0
2021-11-22,CA,23,PL13,85496,85352,264,264,0
2021-05-27,RT,21,PL05,209400,209592,120,120,0
2021-04-17,SD,13,PL22,60494,60117,569,192,377
2021-12-05,SD,13,PL25,50249,47573,2932,256,2676
2021-09-15,SD,13,PL22,75954,75835,341,208,133
2021-09-21,CL,14,PL44,297568,294048,3200,3200,0
2021-12-01,RT,21,PL05,205560,204840,864,864,0
2021-09-04,PR,15,PL04,257312,254464,2944,2944,0
2021-04-20,CH,24,PL12,158432,157888,640,640,0
2021-08-24,SD,13,PL20,75122,75051,440,352,88
2021-01-02,HO,18,PL09,46480,46472,8,8,0
2021-07-31,HO,18,PL30,0,0,0,0,0
2021-12-04,HO,18,PL33,73064,73064,0,0,0
2021-01-21,SD,13,PL19,62791,62604,487,208,279
2021-06-29,HO,18,PL33,132496,132496,0,0,0
2021-09-02,HO,18,PL09,70584,69568,1016,1016,0
2021-06-29,PB,25,PL54,412096,402528,10208,10208,0
2021-07-26,PB,25,PL54,444224,442816,3264,3264,0
2021-03-01,EC,10,PL43,491040,490464,1104,1104,0
2021-06-05,SD,13,PL20,70836,69991,1385,528,857
2021-09-14,EC,10,PL43,599952,599664,624,624,0
2021-01-02,RA,17,PL35,135288,133920,1368,1368,0
2021-05-21,RT,21,PL05,200616,199008,2616,2616,0
2021-10-02,SD,13,PL25,73838,73209,1049,416,633
2021-05-16,RA,17,PL35,148128,145704,2856,2856,0
2021-05-07,CA,23,PL13,85192,85328,96,96,0
2021-11-05,RT,21,PL06,208872,208800,72,72,0
2021-10-07,RT,21,PL05,165936,162192,6528,6528,0
2021-10-25,EC,10,PL43,617904,617184,1152,1152,0
2021-08-23,CA,23,PL13,61112,58592,2672,2672,0
2021-07-08,HO,18,PL33,66216,66216,0,0,0
2021-03-04,CA,23,PL31,199464,197160,2664,2664,0
2021-07-07,HO,18,PL40,65480,65080,400,400,0
2021-10-15,PRG,12,PL14,390976,390144,1152,1152,0
2021-01-21,HO,18,PL01,65792,65616,208,208,0
2021-02-21,RT,21,PL42,187488,185568,2864,2864,0
2021-02-17,RT,21,PL06,191448,189648,2016,2016,0
2021-12-03,SD,13,PL19,23210,21464,5634,3888,1746
2021-07-22,SD,13,PL18,75933,75530,1000,576,424
2021-07-01,PB,25,PL54,405472,398400,8160,8160,0
2021-02-27,HO,18,PL11,66200,66264,0,0,0
2021-04-14,SD,13,PL25,72776,72514,656,416,240
2021-06-24,HO,18,PL33,130336,128912,1424,1424,0
2021-12-06,RT,21,PL42,224,0,224,224,0
2021-11-30,SD,13,PL20,75899,75773,364,176,188
2021-04-09,NT,16,PL51,354816,353120,5600,5600,0
2021-09-24,CA,23,PL13,85296,85064,336,336,0
2021-01-27,RT,21,PL42,0,0,0,0,0
2021-07-12,HO,18,PL03,43168,43008,504,504,0
2021-01-02,RT,21,PL42,0,0,9280,9280,0
2021-04-16,SD,13,PL20,1921,1805,6868,6752,116
2021-04-02,RT,21,PL42,150464,145888,4688,4688,0
2021-08-02,HO,18,PL33,64584,64232,408,408,0
2021-09-11,CA,23,PL31,118200,113664,4512,4512,0
2021-02-22,CL,14,PL44,279136,273152,1312,1312,0
2021-11-16,EC,10,PL43,629856,629712,528,528,0
2021-11-04,SB,11,PL50,454368,448608,6592,6592,0
2021-05-22,SD,13,PL21,69904,69598,617,192,425
2021-12-21,SD,13,PL22,5650,5625,234,192,42
2021-07-22,HO,18,PL30,66136,66016,120,120,0
2021-02-22,SB,11,PL36,296832,294192,3192,3192,0
2021-10-04,HO,18,PL01,66832,66312,672,672,0
2021-04-11,HO,18,PL09,72528,72440,88,88,0
2021-04-09,SB,11,PL50,454080,451712,3008,3008,0
2021-11-06,PRG,12,PL14,380544,379872,1568,1568,0
2021-08-19,HO,18,PL01,22728,22296,1264,1264,0
2021-10-28,CH,24,PL12,165376,165184,192,192,0
2021-09-26,DI,19,PL52,293056,293536,0,0,0
2021-11-17,PW,26,PL37,813744,813072,2160,2160,0
2021-10-31,NT,16,PL51,451488,451392,352,352,0
2021-11-01,CL,14,PL44,298432,295968,1728,1728,0
2021-01-14,RA,17,PL34,220896,220584,312,312,0
2021-03-08,SB,11,PL36,258744,257976,7824,7824,0
2021-01-08,RT,21,PL06,205248,204864,1104,1104,0
2021-12-15,CA,23,PL31,144288,140784,4224,4224,0
2021-10-09,HO,18,PL03,67144,67120,96,96,0
2021-11-05,PW,26,PL37,691488,690864,7920,7920,0
2021-05-05,PR,15,PL04,261440,261440,576,576,0
2021-07-24,PR,15,PL12,67344,66784,528,528,0
2021-06-17,SD,13,PL18,71038,70600,1350,912,438
2021-03-16,HO,18,PL03,66224,66224,0,0,0
2021-03-18,RT,21,PL06,204096,201840,2616,2616,0
2021-01-30,HO,18,PL10,57552,57416,136,136,0
2021-02-09,RT,21,PL05,190104,188808,1968,1968,0
2021-11-12,RT,21,PL05,0,0,2976,2976,0
2021-05-27,HO,18,PL09,67712,65728,1984,1984,0
2021-03-09,CH,24,PL12,162160,161136,1648,1648,0
2021-10-26,DI,19,PL52,290336,289248,1792,1792,0
2021-02-24,EC,10,PL43,620208,620304,1632,1632,0
2021-07-08,SD,13,PL18,58279,58032,481,192,289
2021-06-20,CL,14,PL44,195808,189952,4928,4928,0
2021-08-06,CL,14,PL45,298784,295584,2112,2112,0
2021-10-13,HO,18,PL03,66040,66080,112,112,0
2021-01-26,PR,15,PL04,266400,266240,320,320,0
2021-02-26,RA,17,PL34,222888,223008,0,0,0
2021-08-13,CL,14,PL45,296928,290208,3168,3168,0
2021-11-07,RT,21,PL42,155136,146576,8864,8864,0
2021-10-14,RT,21,PL06,157344,156552,3792,3792,0
2021-02-25,HO,18,PL33,68784,68776,0,0,0
2021-11-28,SD,13,PL22,75826,75863,428,352,76
2021-05-26,CL,14,PL44,296192,291232,4608,4608,0
2021-11-17,CL,14,PL44,218784,214240,6528,6528,0
2021-03-27,HO,18,PL33,61760,60680,1120,1120,0
2021-07-04,CL,14,PL45,301472,296960,1184,1184,0
2021-10-08,RT,21,PL41,59968,52896,7072,7072,0
2021-10-14,PRG,12,PL14,393504,392416,1088,1088,0
2021-08-30,HO,18,PL11,66296,66296,0,0,0
2021-05-09,CA,23,PL31,232248,232032,1416,1416,0
2021-12-17,HO,18,PL01,67624,67304,320,320,0
2021-02-13,SD,13,PL25,46967,46769,2118,1920,198
2021-11-08,HO,18,PL10,67600,66744,968,968,0
2021-07-28,SD,13,PL22,73569,73578,834,832,2
2021-09-16,SD,13,PL19,48487,48418,907,784,123
2021-10-14,CH,24,PL08,261134,258045,6513,3424,3089
2021-05-12,EC,10,PL43,53632,52160,1408,1408,0
2021-11-06,HO,18,PL01,67464,67440,96,96,0
2021-10-07,CH,24,PL08,182671,179841,3598,768,2830
2021-05-19,CH,24,PL08,304436,301690,7834,5088,2746
2021-04-07,SD,13,PL17,74245,73342,1095,192,903
2021-03-16,HO,18,PL09,67440,67400,3632,3632,0
2021-07-01,RT,21,PL06,162240,161808,528,528,0
2021-12-18,HO,18,PL11,65136,65096,304,304,0
2021-09-15,PRG,12,PL14,386976,386496,1024,1024,0
2021-07-08,SD,13,PL19,62956,62922,686,640,46
2021-08-04,HO,18,PL40,66192,65936,256,256,0
2021-06-19,HO,18,PL33,125920,125552,592,592,0
2021-01-25,HO,18,PL09,71192,70984,224,224,0
2021-09-27,CA,23,PL13,78304,78000,528,528,0
2021-12-03,RT,21,PL05,205152,204264,1032,1032,0
2021-05-28,HO,18,PL09,71736,71624,112,112,0
2021-07-06,HO,18,PL32,65144,64984,248,248,0
2021-06-26,DI,19,PL53,298656,298720,352,352,0
2021-03-25,HO,18,PL09,62008,59616,2424,2424,0
2021-04-16,CA,23,PL13,64704,64688,304,304,0
2021-05-14,HO,18,PL33,0,0,304,304,0
2021-12-09,SD,13,PL25,70585,69658,1149,176,973
2021-06-14,CA,23,PL02,180288,179736,1392,1392,0
2021-02-13,DI,19,PL53,294848,294176,1152,1152,0
2021-03-14,SB,11,PL50,459552,458304,1792,1792,0
2021-03-10,CH,24,PL12,162592,162368,480,480,0
2021-06-18,RT,21,PL06,194880,190968,3960,3960,0
2021-06-28,PR,15,PL12,139872,139824,192,192,0
2021-04-08,RT,21,PL42,102832,96320,6560,6560,0
2021-01-16,CA,23,PL13,85288,85344,120,120,0
2021-05-06,CA,23,PL31,166224,164304,2280,2280,0
2021-05-20,CH,24,PL07,272703,266469,10795,3584,7211
2021-06-14,PR,15,PL24,260768,260480,576,576,0
2021-11-23,CA,23,PL31,104808,103392,1992,1992,0
2021-02-02,PRG,12,PL14,389888,389280,1120,1120,0
2021-01-24,SD,13,PL21,17974,17487,2698,768,1930
2021-10-15,NT,16,PL51,431296,430912,1600,1600,0
2021-11-03,RT,21,PL05,199512,198072,1848,1848,0
2021-02-03,HO,18,PL11,64272,64248,360,360,0
2021-06-24,CA,23,PL31,232824,230328,2616,2616,0
2021-12-10,PR,15,PL04,264704,264224,672,672,0
2021-04-17,CL,14,PL45,122432,53216,11616,11616,0
2021-07-15,HO,18,PL56,65256,64464,792,792,0
2021-09-12,SD,13,PL25,75705,74896,985,176,809
2021-07-25,CL,14,PL45,272448,266880,5568,5568,0
2021-09-03,SD,13,PL21,69928,69659,1132,816,316
2021-03-27,DI,19,PL53,272384,271904,768,768,0
2021-04-28,RA,17,PL34,123264,116832,6432,6432,0
2021-09-18,RT,21,PL06,206904,206064,1128,1128,0
2021-10-23,HO,18,PL11,64360,63976,384,384,0
2021-12-19,SD,13,PL25,72423,71912,967,384,583
2021-04-16,CH,24,PL07,138500,130289,31226,7712,23514
2021-06-09,PR,15,PL04,216032,209824,6208,6208,0
2021-08-20,SD,13,PL20,75403,75320,83,0,83
2021-09-02,CL,14,PL44,41824,41216,8448,8448,0
2021-01-16,SD,13,PL17,72649,72541,300,192,108
2021-12-19,HO,18,PL11,65392,65072,320,320,0
2021-09-01,SD,13,PL19,46570,46341,3525,3296,229
2021-09-14,CL,14,PL45,201888,185984,11904,11904,0
2021-12-15,CH,24,PL07,0,0,6562,6464,98
2021-03-14,NT,16,PL51,468800,468576,768,768,0
2021-03-08,CA,23,PL31,222888,219792,3600,3600,0
2021-06-07,SB,11,PL50,444800,443808,2560,2560,0
2021-08-21,HO,18,PL01,61608,60520,1088,1088,0
2021-03-27,CH,24,PL07,297946,276215,26347,4448,21899
2021-01-09,RA,17,PL35,185640,179568,6072,6072,0
2021-03-31,SD,13,PL17,65623,65431,563,368,195
2021-12-06,CH,24,PL07,246306,240217,9614,3232,6382
2021-03-23,RA,17,PL34,183768,180360,3696,3696,0
2021-06-06,HO,18,PL33,132304,132384,0,0,0
2021-01-05,HO,18,PL11,63400,63232,168,168,0
2021-03-18,HO,18,PL11,66216,66104,112,112,0
2021-02-27,SD,13,PL21,72909,72337,748,176,572
2021-05-22,PR,15,PL04,245184,244864,640,640,0
2021-02-01,SD,13,PL21,4017,4219,770,640,130
2021-06-02,RT,21,PL42,185616,174720,10976,10976,0
2021-11-11,CA,23,PL02,231672,231600,456,456,0
2021-03-19,PB,25,PL55,447712,447552,2016,2016,0
2021-10-13,PB,25,PL55,353984,280864,74720,74720,0
2021-09-30,SD,13,PL18,68779,67574,2213,1008,1205
2021-09-13,RT,21,PL06,15768,13680,22584,22584,0
2021-05-18,NT,16,PL51,433888,428864,5760,5760,0
2021-04-11,PB,25,PL55,446016,445664,1088,1088,0
2021-09-20,HO,18,PL09,67472,67280,280,280,0
2021-01-10,CH,24,PL08,269962,255171,24800,9824,14976
2021-11-02,SD,13,PL21,65387,65244,319,176,143
2021-10-08,CL,14,PL45,293312,288192,4320,4320,0
2021-02-07,CL,14,PL44,305056,299008,800,800,0
2021-07-01,EC,10,PL43,613392,610896,2592,2592,0
2021-10-12,HO,18,PL03,67256,67160,96,96,0
2021-07-03,RA,17,PL34,7176,7032,576,576,0
2021-03-06,CH,24,PL12,160448,157936,2784,2784,0
2021-03-31,CH,24,PL12,72000,71920,240,240,0
2021-05-29,SD,13,PL20,68911,68748,339,176,163
2021-12-08,HO,18,PL03,5256,5120,136,136,0
2021-02-22,DI,19,PL53,293536,291424,3008,3008,0
2021-06-09,PR,15,PL24,262720,262368,928,928,0
2021-07-11,CL,14,PL44,297984,292992,1408,1408,0
2021-05-31,EC,10,PL43,602784,600336,2640,2640,0
2021-09-13,RT,21,PL42,188848,187728,1232,1232,0
2021-11-20,HO,18,PL10,68632,68480,152,152,0
2021-05-05,HO,18,PL33,66144,65936,120,120,0
2021-09-06,CL,14,PL45,290496,285408,4288,4288,0
2021-12-04,CA,23,PL02,224616,224304,1080,1080,0
2021-04-07,RT,21,PL42,116560,101904,14656,14656,0
2021-10-05,HO,18,PL32,57648,57648,0,0,0
2021-02-16,DI,19,PL53,280000,278880,1984,1984,0
2021-07-25,SD,13,PL19,51708,51497,1395,1184,211
2021-12-17,SB,11,PL36,306456,305928,1032,1032,0
2021-10-25,RT,21,PL05,204528,202752,2064,2064,0
2021-04-30,CA,23,PL11,220584,214128,6576,6576,0
2021-07-02,CH,24,PL07,298033,291694,10309,3680,6629
2021-09-20,HO,18,PL01,67584,67080,504,504,0
2021-06-30,HO,18,PL01,68296,68296,0,0,0
2021-10-22,CH,24,PL08,304994,285863,23739,4608,19131
2021-01-16,CL,14,PL44,20704,14912,480,480,0
2021-09-28,HO,18,PL11,66288,66176,112,112,0
2021-06-01,CA,23,PL13,85272,85248,88,88,0
2021-09-21,PRG,12,PL14,81056,81216,1984,1984,0
2021-09-02,DI,19,PL52,220064,213920,6272,6272,0
2021-05-31,CH,24,PL07,234942,226927,17141,8896,8245
2021-03-27,SD,13,PL18,56361,55273,2272,1184,1088
2021-03-21,RT,21,PL05,206304,206208,288,288,0
2021-04-28,PR,15,PL04,228128,226464,1664,1664,0
2021-06-21,HO,18,PL10,55392,54400,1096,1096,0
2021-10-05,SD,13,PL19,73471,73066,919,496,423
2021-05-18,HO,18,PL30,63968,63864,104,104,0
2021-12-03,RT,21,PL42,191152,186240,4960,4960,0
2021-01-18,RA,17,PL35,218424,218280,648,648,0
2021-10-24,CL,14,PL45,286656,279296,5600,5600,0
2021-11-02,CH,24,PL08,262002,253570,14767,6336,8431
2021-04-20,SD,13,PL19,75676,75671,235,192,43
2021-03-05,RT,21,PL05,206736,206640,744,744,0
2021-01-22,HO,18,PL11,65168,64496,672,672,0
2021-03-02,SD,13,PL18,71231,70202,1938,784,1154
2021-10-21,SD,13,PL21,61626,61307,1856,1536,320
2021-01-08,PRG,12,PL14,393120,391552,1664,1664,0
2021-05-23,HO,18,PL33,0,0,104,104,0
2021-11-12,HO,18,PL09,67632,67384,416,416,0
2021-08-02,CL,14,PL45,241952,228064,10976,10976,0
2021-05-11,CL,14,PL44,38624,30400,10976,10976,0
2021-09-21,CL,14,PL45,286368,277888,7488,7488,0
2021-05-31,CA,23,PL02,188448,188112,1176,1176,0
2021-10-12,SD,13,PL22,76445,76387,234,176,58
2021-03-27,PB,25,PL54,376992,344512,32960,32960,0
2021-08-24,CH,24,PL08,300960,293567,10095,2528,7567
2021-03-21,CL,14,PL44,302048,294880,1472,1472,0
2021-03-28,CL,14,PL45,307104,300960,608,608,0
2021-04-11,DI,19,PL53,294336,292960,1568,1568,0
2021-05-12,CA,23,PL13,80256,80168,304,304,0
2021-10-02,CL,14,PL45,278688,272352,5312,5312,0
2021-04-26,HO,18,PL40,50760,50600,184,184,0
2021-02-03,CH,24,PL07,212532,198228,19910,5632,14278
2021-02-02,HO,18,PL33,21736,21400,400,400,0
2021-05-10,PR,15,PL04,191264,189600,1792,1792,0
2021-08-25,PRG,12,PL14,392544,392672,928,928,0
2021-04-16,DI,19,PL53,220960,221088,384,384,0
2021-08-25,SD,13,PL18,72991,72666,839,512,327
2021-07-26,RT,21,PL05,14760,14760,0,0,0
2021-10-30,HO,18,PL32,51312,50976,368,368,0
2021-02-24,HO,18,PL01,66216,66008,208,208,0
2021-05-19,HO,18,PL33,64992,64944,304,304,0
2021-10-16,RT,21,PL05,204960,203784,1176,1176,0
2021-02-22,SD,13,PL25,71734,71682,404,352,52
2021-01-26,PRG,12,PL14,389760,388384,1824,1824,0
2021-01-28,SD,13,PL18,70170,69219,1143,192,951
2021-09-21,SB,11,PL36,263208,260976,4104,4104,0
2021-09-06,CA,23,PL13,83032,83016,216,216,0
2021-03-27,PR,15,PL24,242400,241536,2720,2720,0
2021-05-17,PB,25,PL54,440672,438080,3584,3584,0
2021-04-09,HO,18,PL09,61544,61280,264,264,0
2021-07-30,CL,14,PL44,298240,295872,1952,1952,0
2021-08-02,PR,15,PL12,139008,138512,496,496,0
2021-12-11,RA,17,PL34,127824,127368,696,696,0
2021-11-30,DI,19,PL53,220288,216640,5024,5024,0
2021-02-12,HO,18,PL33,47240,46280,1048,1048,0
2021-06-03,RT,21,PL06,206448,205848,816,816,0
2021-08-26,HO,18,PL10,68152,68016,136,136,0
2021-04-11,SD,13,PL20,74622,73841,1230,352,878
2021-10-14,SB,11,PL50,455424,451328,4832,4832,0
2021-06-01,SB,11,PL50,456352,454528,2144,2144,0
2021-12-16,CH,24,PL07,54998,49756,12410,4128,8282
2021-08-01,PW,26,PL37,688512,684000,4656,4656,0
2021-01-17,CA,23,PL13,85400,85232,232,232,0
2021-08-13,CA,23,PL02,3264,3264,0,0,0
2021-09-16,PR,15,PL24,270144,268832,1120,1120,0
2021-02-01,DI,19,PL53,297792,295808,2240,2240,0
2021-04-07,PW,26,PL37,61008,57648,3360,3360,0
2021-11-20,CH,24,PL08,161344,158016,6816,6816,0
2021-08-05,PR,15,PL24,264992,264896,384,384,0
2021-09-05,CA,23,PL31,232296,232272,360,360,0
2021-11-05,CH,24,PL24,141248,140272,1232,1232,0
2021-10-15,HO,18,PL56,66224,66224,0,0,0
2021-07-10,PR,15,PL12,139504,139568,176,176,0
2021-08-20,SD,13,PL18,73618,73142,1157,672,485
2021-03-28,SD,13,PL19,72957,72957,176,176,0
2021-04-11,SD,13,PL18,70130,69293,1400,576,824
2021-04-27,CH,24,PL12,3312,3312,0,0,0
2021-05-06,HO,18,PL10,13936,12336,1600,1600,0
2021-11-16,CA,23,PL13,84704,84272,584,584,0
2021-12-14,HO,18,PL09,66080,65848,232,232,0
2021-07-31,PW,26,PL37,796848,795360,3120,3120,0
2021-12-03,PRG,12,PL14,393248,393152,960,960,0
2021-08-18,HO,18,PL10,0,0,0,0,0
2021-02-28,DI,19,PL53,295360,294944,992,992,0
2021-01-12,SB,11,PL36,317112,316704,816,816,0
2021-04-03,RT,21,PL42,60256,55456,4752,4752,0
2021-02-24,SD,13,PL17,71835,71676,751,592,159
2021-05-22,HO,18,PL32,63712,63648,144,144,0
2021-10-26,SD,13,PL18,75519,74938,1413,816,597
2021-10-28,PB,25,PL55,449536,449088,1280,1280,0
2021-03-10,HO,18,PL11,63592,63528,272,272,0
2021-04-13,DI,19,PL53,297376,295680,2240,2240,0
2021-01-25,PR,15,PL24,263968,261632,2496,2496,0
2021-03-03,CH,24,PL08,115345,113133,4164,1952,2212
2021-03-19,CH,24,PL07,104465,97689,11990,3328,8662
2021-10-28,EC,10,PL43,602112,595776,6720,6720,0
2021-09-18,SD,13,PL22,76716,76672,44,0,44
2021-09-30,PB,25,PL54,156128,151872,4800,4800,0
2021-12-07,HO,18,PL32,57664,57640,24,24,0
2021-05-29,SD,13,PL18,4750,4310,10936,10496,440
2021-04-14,PR,15,PL24,267584,262432,5504,5504,0
2021-09-06,DI,19,PL52,288704,287968,1152,1152,0
2021-10-12,PW,26,PL37,681024,679872,4080,4080,0
2021-06-03,RT,21,PL42,187472,177744,9952,9952,0
2021-08-11,HO,18,PL10,69024,69120,8,8,0
2021-10-16,HO,18,PL09,62800,62504,296,296,0
2021-01-29,DI,19,PL52,296928,296896,352,352,0
2021-04-23,PW,26,PL37,670032,669120,4560,4560,0
2021-02-11,RT,21,PL05,207024,206880,288,288,0
2021-08-30,CH,24,PL07,257849,255807,12020,9920,2100
2021-10-31,SD,13,PL22,74901,74835,655,560,95
2021-04-13,RA,17,PL56,158736,154584,4152,4152,0
2021-03-23,CA,23,PL13,85112,85048,168,168,0
2021-05-01,PR,15,PL04,259296,258624,768,768,0
2021-11-13,SB,11,PL50,453856,454048,1760,1760,0
2021-09-13,SD,13,PL20,75572,75567,392,352,40
2021-03-09,SD,13,PL18,73294,73183,156,0,156
2021-08-11,CH,24,PL08,302592,298445,8659,4512,4147
2021-07-27,HO,18,PL30,66224,66224,0,0,0
2021-05-07,RT,21,PL05,210144,209568,264,264,0
2021-12-17,SD,13,PL19,76162,76073,308,192,116
2021-12-21,CH,24,PL07,294683,291951,7727,4832,2895
2021-05-21,HO,18,PL40,64464,64200,304,304,0
2021-01-04,SD,13,PL20,47095,46893,1841,1328,513
2021-05-24,SD,13,PL22,0,0,0,0,0
2021-01-14,HO,18,PL11,45528,44760,768,768,0
2021-06-01,CA,23,PL11,225816,223656,3144,3144,0
2021-12-08,SB,11,PL50,453856,454080,1504,1504,0
2021-09-21,EC,10,PL43,627408,625056,2064,2064,0
2021-09-22,HO,18,PL01,67424,67288,264,264,0
2021-07-29,HO,18,PL56,0,0,4104,4104,0
2021-08-16,HO,18,PL09,72448,72368,80,80,0
2021-10-14,SD,13,PL17,73454,72856,1670,1072,598
2021-11-28,CH,24,PL24,163040,162752,368,368,0
2021-02-03,EC,10,PL43,420288,421968,1056,1056,0
2021-03-18,CL,14,PL44,304544,298336,1824,1824,0
2021-07-15,CA,23,PL02,229992,229488,1944,1944,0
2021-12-08,SD,13,PL18,67009,66297,1528,816,712
2021-11-20,SD,13,PL21,64201,63612,1229,640,589
2021-05-15,SD,13,PL20,21099,20969,610,480,130
2021-07-18,CA,23,PL02,219432,218520,912,912,0
2021-03-09,HO,18,PL32,65656,65592,392,392,0
2021-12-05,CA,23,PL31,202584,200808,1824,1824,0
2021-10-08,SD,13,PL17,73584,73418,550,384,166
2021-06-08,NT,16,PL51,174240,173792,1984,1984,0
2021-12-09,PR,15,PL04,264512,263360,1152,1152,0
2021-06-26,HO,18,PL32,68256,68008,248,248,0
2021-07-07,PB,25,PL55,450144,449632,1024,1024,0
2021-11-30,RT,21,PL42,154192,151312,2880,2880,0
2021-11-10,HO,18,PL11,47472,46976,672,672,0
2021-04-28,RT,21,PL41,0,0,0,0,0
2021-03-19,SD,13,PL17,74187,73924,631,368,263
2021-08-31,PR,15,PL04,238304,237344,1248,1248,0
2021-11-02,CH,24,PL07,322191,310010,15861,3680,12181
2021-07-03,HO,18,PL32,67488,67424,120,120,0
2021-03-16,PR,15,PL04,264864,264544,352,352,0
2021-12-08,RT,21,PL06,165144,162504,2952,2952,0
2021-11-08,CH,24,PL24,157872,157328,912,912,0
2021-02-26,PRG,12,PL14,393248,391040,2816,2816,0
2021-12-18,HO,18,PL33,12800,12528,424,424,0
2021-04-10,PR,15,PL24,262016,260320,2080,2080,0
2021-06-07,CH,24,PL57,34228,34180,48,48,0
2021-03-29,PR,15,PL24,265728,264608,1504,1504,0
2021-09-03,RT,21,PL05,205344,203808,1536,1536,0
2021-05-12,CH,24,PL07,272969,260714,15523,3136,12387
2021-05-30,HO,18,PL40,64600,63808,792,792,0
2021-03-06,DI,19,PL52,295616,295040,1120,1120,0
2021-05-04,HO,18,PL30,62952,62656,296,296,0
2021-07-25,SD,13,PL20,76492,76495,260,176,84
2021-02-07,RT,21,PL06,206400,202080,4560,4560,0
2021-01-13,HO,18,PL01,66272,66272,0,0,0
2021-07-26,SD,13,PL19,63742,63572,362,192,170
2021-09-09,HO,18,PL10,67720,67632,88,88,0
2021-03-19,CH,24,PL12,164256,164192,176,176,0
2021-05-07,PRG,12,PL14,392128,391072,1056,1056,0
2021-06-22,RT,21,PL06,207624,207456,264,264,0
2021-09-10,HO,18,PL40,66192,66016,176,176,0
2021-02-15,CA,23,PL13,85592,85624,88,88,0
2021-03-06,PW,26,PL37,806592,805824,1776,1776,0
2021-04-07,HO,18,PL10,55936,55768,352,352,0
2021-01-15,CA,23,PL13,72128,72088,264,264,0
2021-03-22,CH,24,PL08,303319,296594,12037,5312,6725
2021-08-27,HO,18,PL01,67736,67256,376,376,0
2021-10-04,SD,13,PL18,73998,73470,753,208,545
2021-02-09,PR,15,PL57,129856,129888,1008,1008,0
2021-06-12,SD,13,PL19,74951,74317,1064,416,648
2021-12-06,SD,13,PL25,70580,67692,3272,368,2904
2021-11-20,SD,13,PL17,70357,70188,361,192,169
2021-01-17,SD,13,PL17,67239,67216,850,736,114
2021-10-04,CL,14,PL45,275808,270144,5312,5312,0
2021-06-11,NT,16,PL51,456448,452992,4032,4032,0
2021-08-08,CH,24,PL57,33700,33556,144,144,0
2021-01-21,SD,13,PL17,41139,41123,656,576,80
2021-03-15,HO,18,PL09,70608,70376,328,328,0
2021-06-03,EC,10,PL43,245184,222336,21696,21696,0
2021-11-15,HO,18,PL09,65464,65360,264,264,0
2021-03-26,DI,19,PL52,64928,64768,160,160,0
2021-04-14,NT,16,PL51,343040,337824,5120,5120,0
2021-08-04,CH,24,PL57,34260,34184,76,76,0
2021-09-15,CH,24,PL08,241425,225273,39192,23040,16152
2021-02-28,CA,23,PL02,230640,225792,4992,4992,0
2021-08-13,CH,24,PL08,309775,277404,40243,7872,32371
2021-09-20,SD,13,PL20,68434,68480,577,544,33
2021-07-31,SD,13,PL18,2936,2923,13,0,13
2021-07-29,RA,17,PL34,162960,159744,3360,3360,0
2021-04-20,RT,21,PL05,206280,206064,288,288,0
2021-06-28,CL,14,PL44,297120,289856,6528,6528,0
2021-04-23,HO,18,PL10,56984,56896,88,88,0
2021-05-12,RA,17,PL56,189936,189480,576,576,0
2021-01-19,HO,18,PL10,56264,56088,176,176,0
2021-05-16,CA,23,PL13,77528,77544,88,88,0
2021-11-02,HO,18,PL11,65664,65520,192,192,0
2021-10-26,SB,11,PL50,324512,322176,4960,4960,0
2021-09-21,SB,11,PL50,460192,458848,1664,1664,0
2021-08-31,SD,13,PL19,50456,50453,446,416,30
2021-02-10,SB,11,PL50,443712,442656,4032,4032,0
2021-06-05,SD,13,PL25,18436,18359,1098,992,106
2021-03-18,SD,13,PL25,71056,71021,512,464,48
2021-04-17,RA,17,PL34,171912,171288,624,624,0
2021-04-23,SD,13,PL20,73705,73471,765,544,221
2021-09-03,RT,21,PL06,0,0,3840,3840,0
2021-12-18,RA,17,PL56,259368,258816,624,624,0
2021-12-15,CH,24,PL08,164963,162380,14231,11648,2583
2021-07-23,CL,14,PL45,281920,272160,9088,9088,0
2021-09-02,PB,25,PL55,0,0,3296,3296,0
2021-02-12,SD,13,PL20,73476,73156,1858,1520,338
2021-06-21,SD,13,PL18,75693,75070,1054,416,638
2021-06-29,SD,13,PL19,75630,75576,422,368,54
2021-12-20,SD,13,PL17,74971,73820,1551,400,1151
2021-04-01,CH,24,PL08,306945,300580,9917,3552,6365
2021-06-05,SD,13,PL19,74831,73105,2065,352,1713
2021-08-12,PB,25,PL54,436576,436160,1120,1120,0
2021-09-16,RT,21,PL05,163560,146808,16752,16752,0
2021-02-26,RT,21,PL06,144096,137760,6576,6576,0
2021-06-20,SD,13,PL17,75104,74721,639,208,431
2021-09-24,RT,21,PL42,180608,177856,3040,3040,0
2021-01-08,SD,13,PL22,23254,23003,2061,1760,301
2021-10-27,RT,21,PL42,165808,158176,8608,8608,0
2021-12-11,CA,23,PL13,85544,85336,360,360,0
2021-07-01,SD,13,PL18,59055,58072,2353,1360,993
2021-10-16,CL,14,PL45,0,0,2464,2464,0
2021-07-02,CH,24,PL57,1864,1824,40,40,0
2021-06-08,HO,18,PL10,56304,55824,608,608,0
2021-06-17,PW,26,PL37,648288,645792,17040,17040,0
2021-08-23,RT,21,PL05,208464,208728,0,0,0
2021-09-22,HO,18,PL30,0,0,4832,4832,0
2021-01-07,HO,18,PL11,66280,66280,0,0,0
2021-07-04,RT,21,PL06,194664,192264,2808,2808,0
2021-02-07,SD,13,PL17,74478,73026,1821,368,1453
2021-03-28,RA,17,PL34,191136,191136,0,0,0
2021-05-04,CA,23,PL11,205032,201288,4440,4440,0
2021-05-15,HO,18,PL09,72400,72288,208,208,0
2021-05-29,PW,26,PL37,810576,809616,2160,2160,0
2021-11-01,CA,23,PL13,85384,85296,120,120,0
2021-02-17,HO,18,PL09,71160,71072,88,88,0
2021-03-16,CH,24,PL08,235758,234970,7028,6240,788
2021-04-25,RT,21,PL42,119488,116016,3552,3552,0
2021-09-29,HO,18,PL30,0,0,1440,1440,0
2021-10-24,PW,26,PL37,816816,818016,1248,1248,0
2021-06-27,SD,13,PL17,71523,70811,906,176,730
2021-11-13,HO,18,PL09,68544,68544,0,0,0
2021-04-15,PW,26,PL37,808464,806976,2640,2640,0
2021-07-01,HO,18,PL32,68088,68000,88,88,0
2021-09-25,PB,25,PL55,448352,447424,1600,1600,0
2021-10-23,HO,18,PL09,64368,64384,280,280,0
2021-11-26,HO,18,PL09,65176,65008,168,168,0
2021-01-12,RT,21,PL06,200640,199896,936,936,0
2021-06-10,SD,13,PL22,57323,56842,2593,2112,481
2021-03-09,SB,11,PL50,300032,281056,20960,20960,0
2021-09-12,CH,24,PL08,307095,301410,11893,6208,5685
2021-02-11,CL,14,PL44,302464,294368,2336,2336,0
2021-05-12,CH,24,PL12,95888,90112,6208,6208,0
2021-01-13,SB,11,PL36,210336,208464,7056,7056,0
2021-07-17,SD,13,PL20,75783,75724,267,208,59
2021-04-13,RT,21,PL05,134136,134184,8688,8688,0
2021-05-04,SD,13,PL21,72421,71876,999,432,567
2021-03-24,SD,13,PL20,75597,75301,509,208,301
2021-06-06,SB,11,PL36,171168,163224,7944,7944,0
2021-02-10,CA,23,PL02,220056,209904,10152,10152,0
2021-06-01,PB,25,PL54,448544,448544,800,800,0
2021-01-19,PR,15,PL04,259648,250784,8960,8960,0
2021-02-16,SD,13,PL17,66667,66608,683,544,139
2021-11-06,SD,13,PL19,69802,67527,2748,464,2284
2021-06-30,CA,23,PL31,229992,228720,1488,1488,0
2021-09-13,RT,21,PL05,169800,169104,816,816,0
2021-09-18,SB,11,PL50,456608,455552,1920,1920,0
2021-04-14,SB,11,PL50,398912,396768,5536,5536,0
2021-12-14,SD,13,PL21,73850,73485,1583,1216,367
2021-09-09,RT,21,PL41,53216,51664,1552,1552,0
2021-04-10,CA,23,PL02,158808,158376,1056,1056,0
2021-10-02,SD,13,PL17,75373,75150,725,432,293
2021-07-03,SD,13,PL21,75114,74799,491,176,315
2021-10-02,PW,26,PL37,809472,809616,2640,2640,0
2021-04-19,RT,21,PL05,118752,118968,0,0,0
2021-03-31,RA,17,PL56,79824,79560,264,264,0
2021-03-16,RA,17,PL35,218664,217776,888,888,0
2021-10-01,CH,24,PL57,32832,32760,228,228,0
2021-04-10,PR,15,PL57,139088,139072,240,240,0
2021-10-27,RT,21,PL06,170544,169584,2088,2088,0
2021-02-09,RT,21,PL41,16624,10384,6240,6240,0
2021-12-05,HO,18,PL01,67192,66536,800,800,0
2021-04-19,CA,23,PL13,0,0,280,280,0
2021-03-26,HO,18,PL30,44136,43960,256,256,0
2021-06-16,RA,17,PL34,181920,178584,4152,4152,0
2021-03-03,SD,13,PL18,32608,32189,2402,1440,962
2021-10-27,NT,16,PL51,510208,510432,640,640,0
2021-03-11,PR,15,PL04,19392,19392,0,0,0
2021-02-06,DI,19,PL52,299200,299392,0,0,0
2021-07-01,SD,13,PL20,69703,69653,450,368,82
2021-08-06,SB,11,PL36,297120,296064,1560,1560,0
2021-08-10,CH,24,PL57,34204,34160,44,44,0
2021-06-08,HO,18,PL01,67176,66952,240,240,0
2021-09-30,HO,18,PL33,132528,132528,0,0,0
2021-03-09,SD,13,PL20,27752,27578,174,0,174
2021-08-12,CL,14,PL44,298144,294144,3328,3328,0
2021-03-15,PRG,12,PL14,386016,382112,4224,4224,0
2021-05-19,CL,14,PL44,11232,11200,7360,7360,0
2021-04-25,CH,24,PL08,1,0,1,0,1
2021-10-09,SD,13,PL17,75074,74933,193,0,193
2021-12-19,HO,18,PL10,68328,68216,112,112,0
2021-07-07,CH,24,PL08,287196,283360,10525,6592,3933
2021-04-12,RT,21,PL42,111984,109248,4048,4048,0
2021-04-12,PR,15,PL57,139920,136928,3104,3104,0
2021-06-08,HO,18,PL09,72000,71904,96,96,0
2021-06-13,CL,14,PL45,0,0,1216,1216,0
2021-05-04,RT,21,PL06,205968,205128,960,960,0
2021-05-27,CA,23,PL11,208296,205008,4320,4320,0
2021-10-26,RT,21,PL05,206688,203088,3648,3648,0
2021-01-20,SD,13,PL20,57729,57595,913,752,161
2021-01-23,CA,23,PL31,99072,96360,2712,2712,0
2021-02-05,CH,24,PL07,103158,101364,1794,0,1794
2021-01-03,RT,21,PL06,192720,192792,360,360,0
2021-01-29,SD,13,PL19,54802,52584,2744,384,2360
2021-06-21,HO,18,PL30,65352,65096,256,256,0
2021-12-09,CA,23,PL35,0,0,208,208,0
2021-05-02,CH,24,PL08,276687,255437,26349,4768,21581
2021-06-16,CA,23,PL11,182928,182856,888,888,0
2021-08-17,HO,18,PL03,22112,21888,224,224,0
2021-10-21,PB,25,PL54,414304,388544,27072,27072,0
2021-03-06,HO,18,PL10,53968,53680,288,288,0
2021-02-05,RA,17,PL34,222792,222480,312,312,0
2021-07-09,EC,10,PL43,629424,629424,528,528,0
2021-06-12,RA,17,PL34,222384,221520,888,888,0
2021-09-11,RA,17,PL35,230160,229104,1080,1080,0
2021-12-06,DI,19,PL52,260064,259104,2336,2336,0
2021-03-12,HO,18,PL03,62920,62560,576,576,0
2021-02-18,SD,13,PL19,65627,65398,1909,1680,229
2021-03-09,HO,18,PL03,65424,65312,112,112,0
2021-09-17,CH,24,PL08,313725,306365,10912,3552,7360
2021-11-29,CA,23,PL31,211584,208992,3000,3000,0
2021-02-17,RA,17,PL34,219696,218280,1416,1416,0
2021-03-05,CH,24,PL07,219924,217224,17048,14048,3000
2021-11-03,CL,14,PL45,287936,283680,3520,3520,0
2021-11-17,HO,18,PL11,65536,65112,424,424,0
2021-07-03,SD,13,PL25,73499,73082,672,176,496
2021-01-22,HO,18,PL03,67672,67712,0,0,0
2021-03-01,CA,23,PL31,196320,193848,3240,3240,0
2021-03-04,CH,24,PL07,247214,235083,45635,33504,12131
2021-08-16,CH,24,PL57,34304,34292,44,44,0
2021-10-31,DI,19,PL53,0,0,128,128,0
2021-05-09,RT,21,PL42,183648,169872,13936,13936,0
2021-11-11,CH,24,PL57,29472,29384,284,284,0
2021-02-23,HO,18,PL32,66888,66744,288,288,0
2021-11-24,RA,17,PL56,3360,3360,0,0,0
2021-06-03,RA,17,PL34,219840,219120,912,912,0
2021-10-26,EC,10,PL43,627408,627120,1392,1392,0
2021-09-14,SD,13,PL22,24306,24246,450,368,82
2021-09-19,SD,13,PL21,60973,60715,862,528,334
2021-06-10,SB,11,PL50,447712,445888,2528,2528,0
2021-06-19,SD,13,PL17,62876,61544,7012,5680,1332
2021-11-18,HO,18,PL10,55504,55504,120,120,0
2021-06-22,HO,18,PL33,130832,130800,208,208,0
2021-04-16,PB,25,PL54,423072,409280,14560,14560,0
2021-09-22,SD,13,PL17,75921,75716,367,176,191
2021-11-12,HO,18,PL10,68136,68232,152,152,0
2021-05-30,SD,13,PL18,73960,73434,527,0,527
2021-08-14,CH,24,PL07,69663,66999,15072,6048,9024
2021-02-13,RA,17,PL34,220608,220536,264,264,0
2021-10-14,PR,15,PL04,182208,180512,2208,2208,0
2021-10-16,RT,21,PL06,196800,189960,6840,6840,0
2021-12-17,EC,10,PL43,625872,625392,576,576,0
2021-05-30,EC,10,PL43,613872,612480,1200,1200,0
2021-06-02,EC,10,PL43,62016,58944,11040,11040,0
2021-10-10,PR,15,PL24,266528,266656,352,352,0
2021-03-02,CA,23,PL02,234384,233712,1272,1272,0
2021-08-12,CH,24,PL07,96928,89460,20949,3744,17205
2021-02-10,PR,15,PL57,142432,142592,400,400,0
2021-01-19,HO,18,PL11,44160,43720,440,440,0
2021-08-25,CA,23,PL31,157488,154464,4560,4560,0
2021-08-31,PRG,12,PL14,392256,392480,960,960,0
2021-11-15,SD,13,PL25,64436,62995,1649,208,1441
2021-01-20,PR,15,PL04,265920,261664,4384,4384,0
2021-04-21,CA,23,PL13,85288,85120,304,304,0
2021-05-25,CA,23,PL31,235560,235152,696,696,0
2021-08-04,EC,10,PL43,628656,627888,912,912,0
2021-12-07,SD,13,PL21,65785,65322,914,384,530
2021-05-28,CA,23,PL11,227952,227208,1008,1008,0
2021-09-18,CH,24,PL08,307822,300733,15573,8256,7317
2021-12-10,SD,13,PL25,53564,52870,1127,432,695
2021-05-16,HO,18,PL09,65584,65496,88,88,0
2021-09-26,PW,26,PL37,546576,518928,28848,28848,0
2021-08-11,SD,13,PL20,66979,66806,901,720,181
2021-06-29,SD,13,PL22,74967,74752,930,608,322
2021-11-11,CA,23,PL31,131952,128112,4440,4440,0
2021-05-10,HO,18,PL32,65472,65360,440,440,0
2021-07-13,HO,18,PL40,63248,62768,480,480,0
2021-08-10,PB,25,PL54,412992,408256,4992,4992,0
2021-02-27,CA,23,PL02,234096,232104,2280,2280,0
2021-02-10,SD,13,PL18,64683,64010,900,192,708
2021-08-13,RT,21,PL05,167952,167472,528,528,0
2021-09-12,HO,18,PL56,66032,65680,352,352,0
2021-09-08,CA,23,PL31,137400,136080,1512,1512,0
2021-11-14,PRG,12,PL12,386784,386048,1024,1024,0
2021-01-20,PB,25,PL55,2112,448,1664,1664,0
2021-04-08,SD,13,PL19,76001,75954,303,256,47
2021-09-21,PR,15,PL04,263968,263072,1376,1376,0
2021-09-17,CA,23,PL31,231456,230328,1224,1224,0
2021-04-06,SD,13,PL25,57334,57088,6790,6544,246
2021-10-22,HO,18,PL56,63960,63816,208,208,0
2021-04-20,PRG,12,PL14,303456,303136,832,832,0
2021-12-19,RT,21,PL06,208896,208776,120,120,0
2021-10-17,SB,11,PL50,462560,461664,1152,1152,0
2021-02-12,HO,18,PL11,65552,65504,144,144,0
2021-09-05,HO,18,PL09,72048,71704,440,440,0
2021-10-19,SD,13,PL18,74480,73958,1344,800,544
2021-11-27,CH,24,PL07,196444,187404,12784,3744,9040
2021-01-13,RT,21,PL06,200088,198264,2688,2688,0
2021-01-30,PRG,12,PL14,391456,391040,864,864,0
2021-08-25,RT,21,PL05,205296,205320,264,264,0
2021-12-14,RT,21,PL05,168792,167784,1488,1488,0
2021-05-22,CA,23,PL13,80352,80280,104,104,0
2021-10-23,NT,16,PL51,502688,502336,800,800,0
2021-01-04,CL,14,PL44,300704,282976,2048,2048,0
2021-09-05,SD,13,PL17,51473,50300,4965,3776,1189
2021-04-30,PB,25,PL55,440480,439136,1536,1536,0
2021-08-12,PB,25,PL55,433568,432192,8896,8896,0
2021-07-29,SD,13,PL17,72438,71547,1105,176,929
2021-06-28,PB,25,PL54,446464,440608,6464,6464,0
2021-12-18,HO,18,PL10,69424,69424,0,0,0
2021-02-21,CH,24,PL08,268416,266592,1824,1824,0
2021-10-26,RT,21,PL06,202512,200472,2040,2040,0
2021-02-10,SB,11,PL36,310488,309672,1512,1512,0
2021-09-07,SB,11,PL50,323328,316480,7456,7456,0
2021-03-09,SD,13,PL19,75858,74044,2662,848,1814
2021-02-25,SB,11,PL36,307296,305784,1800,1800,0
2021-11-24,SD,13,PL22,67196,67131,609,544,65
2021-11-20,CA,23,PL02,161280,160872,912,912,0
2021-05-04,SD,13,PL19,73443,73405,647,608,39
2021-12-01,HO,18,PL40,64224,63832,440,440,0
2021-01-12,SD,13,PL21,69414,68454,1986,1008,978
2021-06-18,CH,24,PL07,213845,207189,11907,5056,6851
2021-06-02,SD,13,PL20,74131,73835,1083,784,299
2021-10-28,SD,13,PL20,76806,76637,185,0,185
2021-03-31,EC,10,PL43,0,0,9744,9744,0
2021-06-24,SB,11,PL36,175632,172584,5232,5232,0
2021-08-04,HO,18,PL30,46336,46264,160,160,0
2021-07-23,HO,18,PL10,20152,19952,200,200,0
2021-10-16,CH,24,PL57,34096,34052,44,44,0
2021-06-01,PB,25,PL55,445664,442688,4352,4352,0
2021-07-22,RT,21,PL42,32448,24368,8080,8080,0
2021-05-11,NT,16,PL51,468800,468352,736,736,0
2021-08-13,CH,24,PL57,33712,33640,108,108,0
2021-12-20,CA,23,PL31,231648,223368,8424,8424,0
2021-08-16,SD,13,PL19,67399,66399,1342,448,894
2021-08-10,HO,18,PL56,63680,63096,720,720,0
2021-01-19,SD,13,PL17,71457,71396,712,576,136
2021-06-10,HO,18,PL30,65360,65264,112,112,0
2021-12-09,RT,21,PL41,0,0,0,0,0
2021-01-24,HO,18,PL01,66248,66024,224,224,0
2021-07-19,RT,21,PL42,178368,156480,22272,22272,0
2021-12-23,SD,13,PL21,18309,18159,155,0,155
2021-10-19,SD,13,PL25,72366,70466,2282,368,1914
2021-02-17,RA,17,PL56,169536,169512,1056,1056,0
2021-08-21,CA,23,PL02,226992,225960,1272,1272,0
2021-03-11,HO,18,PL32,68648,68648,0,0,0
2021-11-14,EC,10,PL43,632256,632160,48,48,0
2021-07-03,PB,25,PL54,442880,432160,11296,11296,0
2021-06-20,CH,24,PL07,241252,226357,27720,12640,15080
2021-03-19,PRG,12,PL14,330112,313504,16608,16608,0
2021-03-20,CA,23,PL13,76240,74776,1464,1464,0
2021-11-29,HO,18,PL10,65760,65704,152,152,0
2021-02-15,SB,11,PL50,440960,439232,3744,3744,0
2021-10-26,SD,13,PL22,75773,75669,760,656,104
2021-02-12,SB,11,PL50,357792,345344,13056,13056,0
2021-02-16,SD,13,PL22,72960,72788,540,368,172
2021-05-11,CH,24,PL07,309564,288549,25494,4384,21110
2021-01-07,EC,10,PL43,3440,3424,0,0,0
2021-04-06,HO,18,PL01,65680,65512,208,208,0
2021-04-15,NT,16,PL51,331616,321536,10272,10272,0
2021-02-24,HO,18,PL33,67152,67072,88,88,0
2021-01-29,PW,26,PL37,812832,809472,4848,4848,0
2021-11-16,CA,23,PL02,228864,228096,1320,1320,0
2021-01-11,CL,14,PL44,302816,289440,1728,1728,0
2021-10-13,HO,18,PL56,63896,63560,336,336,0
2021-11-25,HO,18,PL09,66264,66264,0,0,0
2021-12-01,EC,10,PL43,613392,610752,2928,2928,0
2021-12-08,PR,15,PL24,261568,261280,608,608,0
2021-10-31,PRG,12,PL14,390400,389600,1344,1344,0
2021-02-02,EC,10,PL43,206352,206640,528,528,0
2021-06-19,CL,14,PL44,295424,284736,9568,9568,0
2021-02-22,PW,26,PL37,814608,812160,3792,3792,0
2021-06-21,HO,18,PL33,132368,132064,304,304,0
2021-10-21,CL,14,PL45,281408,275264,5952,5952,0
2021-06-22,PW,26,PL37,789456,774768,16272,16272,0
2021-09-08,RA,17,PL35,168528,166368,2880,2880,0
2021-10-16,HO,18,PL40,65344,65216,128,128,0
2021-03-13,SD,13,PL18,5893,1779,9226,5104,4122
2021-06-02,SD,13,PL18,67501,66924,1249,672,577
2021-03-29,NT,16,PL57,14864,14864,0,0,0
2021-07-15,HO,18,PL32,64360,64264,96,96,0
2021-09-13,SB,11,PL50,277056,273344,4192,4192,0
2021-08-16,HO,18,PL01,67256,65592,1664,1664,0
2021-10-28,SD,13,PL18,69169,68159,1859,848,1011
2021-06-18,HO,18,PL01,68192,67808,384,384,0
2021-06-29,SD,13,PL20,75921,75850,281,192,89
2021-01-10,SD,13,PL20,73883,73298,1514,928,586
2021-12-20,RA,17,PL56,260760,260448,672,672,0
2021-05-06,RT,21,PL06,180336,178512,2688,2688,0
2021-10-15,PB,25,PL54,443936,441696,3136,3136,0
2021-09-27,DI,19,PL53,298304,298752,0,0,0
2021-06-03,CA,23,PL13,85560,85504,88,88,0
2021-09-14,NT,16,PL51,509728,508544,1536,1536,0
2021-10-27,SD,13,PL21,52722,52457,311,0,311
2021-05-25,SB,11,PL36,295896,291648,4560,4560,0
2021-05-02,SD,13,PL17,73911,73272,815,176,639
2021-02-17,CH,24,PL08,312384,310752,2400,2400,0
2021-04-17,PW,26,PL37,634272,633120,1872,1872,0
2021-01-25,CA,23,PL02,237480,236424,1584,1584,0
2021-06-15,SD,13,PL22,72206,72125,649,544,105
2021-11-15,CH,24,PL07,21279,10186,20325,2656,17669
2021-01-31,HO,18,PL11,65008,64936,264,264,0
2021-11-08,SD,13,PL25,62988,61950,1694,656,1038
2021-04-19,PRG,12,PL14,0,0,864,864,0
2021-10-09,CL,14,PL45,294816,290112,3360,3360,0
2021-02-13,CL,14,PL44,284896,282496,480,480,0
2021-12-08,PW,26,PL37,813504,812400,2976,2976,0
2021-01-22,HO,18,PL10,56648,56384,328,328,0
2021-03-01,RA,17,PL56,219720,219168,696,696,0
2021-06-05,CA,23,PL11,234960,234744,696,696,0
2021-03-19,HO,18,PL11,65560,65192,392,392,0
2021-07-18,HO,18,PL09,72024,71992,96,96,0
2021-02-14,SD,13,PL21,72995,71610,1440,0,1440
2021-08-11,SD,13,PL18,74168,73889,1657,1312,345
2021-10-24,CH,24,PL57,34100,34008,88,88,0
2021-01-06,RA,17,PL34,183504,178392,5256,5256,0
2021-04-27,SB,11,PL50,159616,159840,512,512,0
2021-04-21,HO,18,PL30,64296,63984,496,496,0
2021-08-21,RT,21,PL05,205416,205104,384,384,0
2021-09-05,SD,13,PL18,68463,68162,818,496,322
2021-09-30,NT,16,PL51,449504,441664,9696,9696,0
2021-05-13,CH,24,PL08,272010,266119,21894,15776,6118
2021-08-04,SD,13,PL18,70547,70008,1051,512,539
2021-08-12,RT,21,PL42,189120,179776,11184,11184,0
2021-09-05,CA,23,PL02,233304,232728,1008,1008,0
2021-09-23,HO,18,PL32,57552,57480,88,88,0
2021-12-10,RA,17,PL34,64248,62064,3360,3360,0
2021-01-24,SD,13,PL25,73261,72956,481,176,305
2021-08-28,HO,18,PL11,62544,62040,568,568,0
2021-10-22,CA,23,PL13,85632,85584,152,152,0
2021-04-08,RA,17,PL56,184440,181128,7728,7728,0
2021-12-11,DI,19,PL52,162112,161344,768,768,0
2021-02-28,HO,18,PL32,65096,64976,400,400,0
2021-03-18,HO,18,PL09,71024,70496,616,616,0
2021-01-30,CH,24,PL07,88996,84929,8259,4192,4067
2021-05-29,CA,23,PL11,235056,234312,1224,1224,0
2021-09-19,HO,18,PL11,66328,66328,0,0,0
2021-02-16,CL,14,PL45,298240,283616,1728,1728,0
2021-04-07,HO,18,PL03,66216,66104,120,120,0
2021-07-06,CA,23,PL31,0,0,288,288,0
2021-09-16,CA,23,PL02,192912,192672,624,624,0
2021-04-24,HO,18,PL10,55600,55264,360,360,0
2021-04-17,DI,19,PL53,230144,229760,512,512,0
2021-09-27,RT,21,PL41,112576,105152,7424,7424,0
2021-03-16,SD,13,PL19,74840,73781,2131,1072,1059
2021-07-10,PRG,12,PL14,391200,390304,896,896,0
2021-08-23,HO,18,PL01,66496,65760,736,736,0
2021-06-29,HO,18,PL40,65640,65144,496,496,0
2021-03-26,SD,13,PL22,47788,47218,788,176,612
2021-06-30,CA,23,PL57,24228,24000,228,228,0
2021-03-24,CA,23,PL13,84464,84432,80,80,0
2021-01-07,HO,18,PL33,67824,67744,136,136,0
2021-08-10,HO,18,PL11,66296,66296,0,0,0
2021-03-05,CA,23,PL02,239136,238632,768,768,0
2021-02-19,PRG,12,PL14,392896,392288,832,832,0
2021-11-23,CH,24,PL07,271219,258448,16387,3616,12771
2021-12-06,SD,13,PL19,66219,65060,1351,192,1159
2021-08-26,RT,21,PL06,0,0,696,696,0
2021-03-21,HO,18,PL30,66136,66176,0,0,0
2021-06-20,PB,25,PL54,448448,445696,2752,2752,0
2021-06-30,DI,19,PL52,290112,287648,2656,2656,0
2021-11-05,RT,21,PL05,168360,167040,6072,6072,0
2021-03-22,NT,16,PL57,153376,153088,368,368,0
2021-02-05,HO,18,PL03,65352,65024,440,440,0
2021-12-20,SD,13,PL21,72990,72472,518,0,518
2021-07-06,PB,25,PL54,439872,436480,4032,4032,0
2021-09-04,RT,21,PL42,127216,119760,7456,7456,0
2021-02-03,NT,16,PL51,272928,273248,96,96,0
2021-04-22,CH,24,PL08,288377,282576,9308,3296,6012
2021-09-24,CH,24,PL08,302396,299875,8566,5888,2678
2021-05-16,CH,24,PL12,148304,148464,176,176,0
2021-03-20,CA,23,PL31,211896,210840,1368,1368,0
2021-05-30,NT,16,PL51,326720,326368,352,352,0
2021-03-23,RT,21,PL42,116176,113488,2816,2816,0
2021-11-08,CH,24,PL07,292242,290652,5425,3360,2065
2021-12-03,HO,18,PL10,68336,68392,288,288,0
2021-02-05,CL,14,PL45,305696,299520,960,960,0
2021-07-03,HO,18,PL10,17160,15664,1584,1584,0
2021-11-20,CL,14,PL45,287776,279136,3072,3072,0
2021-01-20,HO,18,PL03,66552,66368,232,232,0
2021-01-09,HO,18,PL10,48688,46912,1776,1776,0
2021-05-26,PRG,12,PL14,387808,387392,1216,1216,0
2021-09-08,CH,24,PL57,34076,34060,52,52,0
2021-10-16,EC,10,PL43,553296,553392,6912,6912,0
2021-12-04,RT,21,PL05,76800,70176,6624,6624,0
2021-02-09,RA,17,PL34,156288,148440,9888,9888,0
2021-05-31,CH,24,PL08,274663,262765,21858,9856,12002
2021-08-05,HO,18,PL40,66200,66016,184,184,0
2021-08-07,RT,21,PL42,93376,92608,3712,3712,0
2021-05-22,DI,19,PL52,137184,137088,96,96,0
2021-03-05,SB,11,PL36,302832,295944,7776,7776,0
2021-01-18,DI,19,PL52,296640,296384,352,352,0
2021-09-09,HO,18,PL56,66216,66216,0,0,0
2021-10-02,HO,18,PL01,66240,65808,544,544,0
2021-03-30,PB,25,PL55,449408,449088,1376,1376,0
2021-08-11,PR,15,PL12,138800,138672,256,256,0
2021-12-22,HO,18,PL33,69176,69056,328,328,0
2021-03-31,RT,21,PL05,195168,195216,1008,1008,0
2021-09-20,RT,21,PL41,147360,141200,6160,6160,0
2021-09-07,SD,13,PL17,73316,72849,835,368,467
2021-11-18,HO,18,PL01,66440,65736,720,720,0
2021-11-17,SD,13,PL18,74194,73856,1052,592,460
2021-03-09,CA,23,PL31,185376,184920,1440,1440,0
2021-07-08,PRG,12,PL14,0,0,7616,7616,0
2021-01-05,CL,14,PL44,258688,237344,6176,6176,0
2021-04-15,DI,19,PL53,294240,293376,1184,1184,0
2021-02-19,RT,21,PL42,150352,148096,2256,2256,0
2021-03-09,HO,18,PL10,51040,49824,1240,1240,0
2021-01-31,HO,18,PL01,66224,66224,0,0,0
2021-03-03,PB,25,PL55,0,0,15648,15648,0
2021-09-06,SD,13,PL20,50686,48328,3850,1280,2570
2021-05-24,HO,18,PL01,20312,20032,456,456,0
2021-05-17,SB,11,PL36,312576,311544,1464,1464,0
2021-07-11,HO,18,PL01,67792,67568,272,272,0
2021-01-16,HO,18,PL10,57296,57368,0,0,0
2021-06-28,SD,13,PL19,74518,74447,263,192,71
2021-01-09,RA,17,PL34,218952,217272,1944,1944,0
2021-12-08,SD,13,PL25,65809,64115,2442,736,1706
2021-02-28,CL,14,PL45,303552,292096,512,512,0
2021-03-28,PB,25,PL55,319840,313248,8128,8128,0
2021-03-06,CH,24,PL08,302651,296332,12982,6432,6550
2021-04-29,SD,13,PL19,74131,73984,1552,1360,192
2021-06-08,SD,13,PL21,42607,42273,744,176,568
2021-02-02,RA,17,PL35,63912,63504,408,408,0
2021-09-06,SD,13,PL22,72962,72919,452,384,68
2021-11-29,CH,24,PL07,152661,151316,2769,1408,1361
2021-11-30,SD,13,PL25,58620,57062,2251,672,1579
2021-07-09,SD,13,PL20,75987,75964,211,176,35
2021-05-12,PR,15,PL04,250560,249984,672,672,0
2021-12-05,CH,24,PL07,0,0,6528,6528,0
2021-01-26,SD,13,PL25,60327,59693,838,192,646
2021-02-18,SD,13,PL21,15157,15011,1007,400,607
2021-03-24,RT,21,PL42,134560,131248,10000,10000,0
2021-06-27,PR,15,PL12,139680,139664,192,192,0
2021-02-27,CA,23,PL31,226608,225672,1440,1440,0
2021-09-29,HO,18,PL32,57632,57632,0,0,0
2021-03-27,SD,13,PL20,70749,70492,721,464,257
2021-01-19,PRG,12,PL14,388960,388160,1152,1152,0
2021-06-30,EC,10,PL43,623232,621648,1344,1344,0
2021-01-23,DI,19,PL53,283936,277952,6400,6400,0
2021-05-26,SD,13,PL19,64702,64390,856,544,312
2021-05-08,PW,26,PL37,808464,805824,3792,3792,0
2021-11-09,PW,26,PL37,806160,806928,1920,1920,0
2021-06-22,RA,17,PL35,223248,222624,864,864,0
2021-07-11,HO,18,PL10,68896,68856,104,104,0
2021-02-01,PR,15,PL57,142672,142496,176,176,0
2021-02-21,SD,13,PL17,72982,72877,350,192,158
2021-05-07,HO,18,PL30,62632,62512,368,368,0
2021-11-21,PW,26,PL37,776304,774816,2640,2640,0
2021-05-07,HO,18,PL03,66392,66392,0,0,0
2021-12-04,HO,18,PL03,66232,66232,0,0,0
2021-12-11,PR,15,PL04,267168,267200,224,224,0
2021-09-15,SD,13,PL17,74967,74713,496,224,272
2021-09-15,CH,24,PL57,34156,34128,56,56,0
2021-04-23,RA,17,PL34,66552,58032,8520,8520,0
2021-11-24,CA,23,PL31,142056,137544,5304,5304,0
2021-06-29,CL,14,PL45,295712,293152,2016,2016,0
2021-08-06,RA,17,PL34,219576,219288,768,768,0
2021-08-26,CH,24,PL07,150292,146492,12824,9024,3800
2021-09-29,RA,17,PL34,200376,195792,6480,6480,0
2021-06-15,CA,23,PL11,237576,237600,360,360,0
2021-11-19,PW,26,PL37,812304,781392,30960,30960,0
2021-02-24,SD,13,PL25,72068,72034,210,176,34
2021-04-08,RA,17,PL35,198840,193632,5544,5544,0
2021-02-06,HO,18,PL09,72520,72528,96,96,0
2021-08-23,HO,18,PL10,6136,6136,0,0,0
2021-01-15,CA,23,PL31,196272,195408,1344,1344,0
2021-03-25,PRG,12,PL14,389024,388448,736,736,0
2021-05-21,HO,18,PL10,54720,54568,152,152,0
2021-08-20,CH,24,PL07,226516,224046,16154,13344,2810
2021-11-09,PRG,12,PL14,134528,133952,576,576,0
2021-04-29,CH,24,PL12,133072,132480,592,592,0
2021-05-30,CH,24,PL08,238681,224433,25998,10528,15470
2021-05-20,HO,18,PL09,66976,66008,992,992,0
2021-03-14,RT,21,PL06,206328,204936,1992,1992,0
2021-04-27,HO,18,PL10,54000,53864,248,248,0
2021-10-18,SD,13,PL18,72603,72093,883,368,515
2021-03-25,RA,17,PL34,199728,197088,2760,2760,0
2021-04-17,HO,18,PL32,53520,53480,144,144,0
2021-01-14,RA,17,PL35,189240,188928,1464,1464,0
2021-05-18,CH,24,PL07,193770,186019,16077,6464,9613
2021-03-13,CL,14,PL45,306176,289728,896,896,0
2021-09-07,PRG,12,PL14,393184,392384,1216,1216,0
2021-06-02,SB,11,PL36,301824,299184,2976,2976,0
2021-01-18,HO,18,PL09,72016,71984,176,176,0
2021-02-13,RT,21,PL05,204456,204528,504,504,0
2021-02-28,CH,24,PL07,279395,262967,28791,11648,17143
2021-10-09,SD,13,PL20,74771,74267,583,0,583
2021-01-24,SD,13,PL22,59875,59286,1013,384,629
2021-03-16,RA,17,PL56,217752,211488,6744,6744,0
2021-11-30,RA,17,PL56,225192,222624,2664,2664,0
2021-07-31,HO,18,PL33,65912,65600,320,320,0
2021-07-26,CH,24,PL07,153030,146911,9063,2944,6119
2021-02-19,CA,23,PL13,51560,51544,112,112,0
2021-03-08,CH,24,PL08,274944,273101,10487,8256,2231
2021-08-20,HO,18,PL09,72024,72016,96,96,0
2021-04-21,HO,18,PL09,69776,69072,744,744,0
2021-12-06,PR,15,PL24,267840,267712,384,384,0
2021-03-06,SD,13,PL17,72518,72149,1055,672,383
2021-04-02,CH,24,PL08,299171,293837,11222,5888,5334
2021-10-24,CH,24,PL12,164656,163696,1056,1056,0
2021-01-27,RT,21,PL06,209736,209520,216,216,0
2021-05-11,HO,18,PL10,49968,49392,880,880,0
2021-11-09,RT,21,PL42,105344,87376,17968,17968,0
2021-11-20,RT,21,PL06,203928,203952,864,864,0
2021-10-19,CH,24,PL07,222805,215568,11913,4384,7529
2021-08-12,HO,18,PL10,68776,68608,168,168,0
2021-09-29,SD,13,PL17,76269,76020,425,176,249
2021-11-11,RA,17,PL34,212040,205008,7416,7416,0
2021-11-16,HO,18,PL01,40592,39936,1264,1264,0
2021-09-18,HO,18,PL01,67808,67624,184,184,0
2021-02-04,RA,17,PL56,222720,222720,0,0,0
2021-07-05,PR,15,PL24,264544,264512,352,352,0
2021-08-24,PR,15,PL04,353632,353472,736,736,0
2021-04-16,HO,18,PL30,66200,66200,0,0,0
2021-04-27,EC,10,PL43,0,0,8240,8240,0
2021-05-25,SD,13,PL18,7985,5172,13741,10928,2813
2021-07-15,HO,18,PL40,60784,60104,680,680,0
2021-11-21,PRG,12,PL14,390400,389056,2304,2304,0
2021-01-05,PRG,12,PL12,380224,374880,5568,5568,0
2021-07-22,HO,18,PL40,65912,64872,1040,1040,0
2021-02-26,SD,13,PL25,70045,69987,1402,1344,58
2021-02-23,CL,14,PL44,161856,153184,3424,3424,0
2021-02-12,RA,17,PL35,221304,220440,864,864,0
2021-03-18,PW,26,PL37,817248,817056,1440,1440,0
2021-05-27,SD,13,PL20,74355,74244,997,544,453
2021-05-06,SD,13,PL21,73650,73078,856,352,504
2021-02-02,HO,18,PL11,66144,65752,408,408,0
2021-11-18,SD,13,PL22,76226,76136,282,176,106
2021-03-21,PR,15,PL04,267744,267744,0,0,0
2021-04-03,CA,23,PL31,120552,114672,6672,6672,0
2021-05-09,RA,17,PL35,224448,224520,600,600,0
2021-10-03,PB,25,PL54,415072,407136,8448,8448,0
2021-07-05,PRG,12,PL14,0,0,4320,4320,0
2021-02-08,HO,18,PL32,67760,67544,256,256,0
2021-02-25,NT,16,PL57,147104,142080,5024,5024,0
2021-12-08,SD,13,PL20,48635,47370,1745,480,1265
2021-10-06,SD,13,PL19,51353,50626,1774,976,798
2021-10-31,CA,23,PL02,234456,232152,2304,2304,0
2021-02-07,RT,21,PL05,209352,209664,0,0,0
2021-05-24,PB,25,PL54,441824,438784,3040,3040,0
2021-04-12,SD,13,PL18,72196,71726,1126,656,470
2021-11-26,DI,19,PL53,232544,228288,4608,4608,0
2021-05-28,CL,14,PL44,292416,284064,7648,7648,0
2021-12-02,PR,15,PL04,263808,263264,608,608,0
2021-12-20,HO,18,PL01,64192,63616,576,576,0
2021-02-19,SD,13,PL21,72538,71982,836,192,644
2021-03-20,SD,13,PL19,55645,54525,8437,7264,1173
2021-07-20,HO,18,PL09,33232,32080,1152,1152,0
2021-09-24,RT,21,PL06,165936,162504,3768,3768,0
2021-02-12,DI,19,PL52,251232,248672,2656,2656,0
2021-05-06,NT,16,PL51,456224,454976,1472,1472,0
2021-11-24,SD,13,PL17,13534,11701,12409,10576,1833
2021-12-16,EC,10,PL43,622128,621504,576,576,0
2021-07-17,SD,13,PL19,65059,65041,194,176,18
2021-01-21,CA,23,PL13,85160,85144,136,136,0
2021-10-13,SD,13,PL19,72449,72135,506,192,314
2021-05-24,CH,24,PL07,312526,294789,21944,3872,18072
2021-02-16,RA,17,PL56,213216,212640,912,912,0
2021-06-02,SD,13,PL21,76274,75672,881,192,689
2021-03-10,RA,17,PL35,220536,219744,792,792,0
2021-12-07,CH,24,PL57,31892,31856,72,72,0
2021-11-04,SD,13,PL20,71555,71417,733,608,125
2021-02-19,SD,13,PL25,72137,72087,258,208,50
2021-02-15,RT,21,PL05,206832,206712,288,288,0
2021-03-23,CA,23,PL02,196104,194592,1512,1512,0
2021-05-22,HO,18,PL30,62664,62664,0,0,0
2021-11-13,PRG,12,PL14,330912,322848,8384,8384,0
2021-01-20,PRG,12,PL14,34688,34656,32,32,0
2021-03-14,RA,17,PL34,220224,219480,840,840,0
2021-06-29,HO,18,PL01,67024,66768,264,264,0
2021-10-12,SB,11,PL36,106872,106728,144,144,0
2021-10-14,PB,25,PL54,399872,381984,18240,18240,0
2021-05-15,RA,17,PL35,212040,210672,2088,2088,0
2021-05-21,CA,23,PL31,155712,155880,384,384,0
2021-10-14,NT,16,PL51,509344,507968,2432,2432,0
2021-04-09,RT,21,PL42,186640,181296,5888,5888,0
2021-02-20,CH,24,PL07,253708,247967,10622,4512,6110
2021-07-26,HO,18,PL01,65208,64024,1184,1184,0
2021-06-23,EC,10,PL43,623616,619632,4176,4176,0
2021-04-15,SB,11,PL50,323040,319968,3904,3904,0
2021-03-04,HO,18,PL32,68512,68480,88,88,0
2021-07-12,HO,18,PL40,64752,64544,800,800,0
2021-04-29,HO,18,PL10,33160,31552,1608,1608,0
2021-08-13,CL,14,PL44,293664,290688,2464,2464,0
2021-02-25,HO,18,PL32,67976,67680,296,296,0
2021-09-20,PB,25,PL55,284000,284256,1248,1248,0
2021-04-13,HO,18,PL10,56704,56672,104,104,0
2021-01-26,RA,17,PL35,218712,218448,528,528,0
2021-11-14,SD,13,PL18,68210,67268,1513,544,969
2021-12-18,RT,21,PL06,203592,203568,624,624,0
2021-05-05,RA,17,PL35,176640,176400,2088,2088,0
2021-03-15,CH,24,PL07,287620,276552,15260,4192,11068
2021-08-08,PR,15,PL12,139152,139088,176,176,0
2021-10-02,RA,17,PL35,35184,11256,23928,23928,0
2021-04-25,SD,13,PL22,75904,75370,780,176,604
2021-01-30,SD,13,PL19,65614,64125,1666,176,1490
2021-08-15,HO,18,PL10,68312,68336,104,104,0
2021-08-20,HO,18,PL11,0,0,32,32,0
2021-01-08,PR,15,PL04,262048,261440,736,736,0
2021-08-22,SD,13,PL17,0,0,16,0,16
2021-05-03,HO,18,PL32,67056,66824,296,296,0
2021-11-06,CA,23,PL13,71576,71384,448,448,0
2021-01-25,NT,16,PL51,0,0,3648,3648,0
2021-01-23,PRG,12,PL12,390656,390336,992,992,0
2021-12-16,CH,24,PL12,158944,157712,1328,1328,0
2021-06-07,HO,18,PL01,67800,67248,600,600,0
2021-07-17,HO,18,PL09,71856,71816,112,112,0
2021-01-07,RA,17,PL35,172416,166344,6624,6624,0
2021-07-11,SD,13,PL17,71675,69722,2152,176,1976
2021-10-14,SD,13,PL22,41940,39849,3611,1520,2091
2021-09-07,CH,24,PL12,158512,156272,2544,2544,0
2021-01-27,SB,11,PL50,343360,336512,7264,7264,0
2021-01-07,PRG,12,PL12,157056,156736,320,320,0
2021-09-24,NT,16,PL51,506944,507072,1152,1152,0
2021-09-11,DI,19,PL53,294944,294016,1216,1216,0
2021-12-14,PR,15,PL24,262688,260672,2400,2400,0
2021-07-19,SD,13,PL17,68263,66155,2732,576,2156
2021-09-23,HO,18,PL09,67312,67296,120,120,0
2021-02-25,RT,21,PL05,209616,209976,0,0,0
2021-09-05,RT,21,PL05,202200,202056,864,864,0
2021-10-18,CH,24,PL57,34280,34240,40,40,0
2021-12-22,HO,18,PL01,66440,65952,576,576,0
2021-11-23,RT,21,PL42,188512,186640,2496,2496,0
2021-06-24,SB,11,PL50,455232,453632,2272,2272,0
2021-08-23,HO,18,PL09,72000,71864,344,344,0
2021-08-14,HO,18,PL11,64088,63992,152,152,0
2021-10-03,DI,19,PL52,287552,287680,384,384,0
2021-07-14,HO,18,PL09,60224,60032,192,192,0
2021-11-13,CH,24,PL07,297869,295781,5032,2944,2088
2021-01-30,HO,18,PL11,65080,64968,112,112,0
2021-06-12,EC,10,PL43,624912,624144,576,576,0
2021-04-26,HO,18,PL32,6896,6800,96,96,0
2021-09-21,DI,19,PL52,293472,293824,0,0,0
2021-02-17,DI,19,PL53,298752,297088,1664,1664,0
2021-05-25,DI,19,PL53,285952,281728,4352,4352,0
2021-06-23,RA,17,PL34,220920,220776,408,408,0
2021-07-31,HO,18,PL56,63064,62088,976,976,0
2021-11-12,RT,21,PL42,38096,4400,33696,33696,0
2021-09-30,DI,19,PL53,246848,246848,512,512,0
2021-06-09,CA,23,PL13,0,0,0,0,0
2021-08-13,HO,18,PL33,20040,20040,0,0,0
2021-05-22,RT,21,PL05,194856,194688,168,168,0
2021-11-25,SD,13,PL20,69439,69209,1158,928,230
2021-04-06,HO,18,PL32,0,0,1584,1584,0
2021-11-23,CL,14,PL45,291456,282816,3872,3872,0
2021-08-06,RT,21,PL41,24224,1344,22880,22880,0
2021-10-24,PB,25,PL55,448160,439616,9056,9056,0
2021-11-23,CA,23,PL02,181200,180792,672,672,0
2021-07-01,SD,13,PL17,69988,69001,1861,864,997
2021-07-09,HO,18,PL09,73144,73056,88,88,0
2021-01-03,SD,13,PL18,72456,71873,953,368,585
2021-02-06,SD,13,PL25,73061,72892,402,192,210
2021-09-14,HO,18,PL03,67664,67664,0,0,0
2021-11-04,PRG,12,PL12,388512,386592,2496,2496,0
2021-05-06,HO,18,PL40,63416,62808,608,608,0
2021-06-19,HO,18,PL03,61936,61152,904,904,0
2021-11-29,SD,13,PL22,75430,75340,475,384,91
2021-12-21,HO,18,PL10,2904,2888,128,128,0
2021-11-10,DI,19,PL52,286752,284448,2560,2560,0
2021-05-08,HO,18,PL03,65496,65496,104,104,0
2021-08-15,HO,18,PL33,60488,59672,816,816,0
2021-05-25,RT,21,PL05,198336,195312,3528,3528,0
2021-10-07,CA,23,PL13,84352,84544,96,96,0
2021-02-13,HO,18,PL11,66192,66272,0,0,0
2021-12-10,PW,26,PL37,794592,761952,36576,36576,0
2021-03-27,RA,17,PL56,198432,194328,4200,4200,0
2021-07-07,CA,23,PL02,234552,233064,1656,1656,0
2021-05-15,HO,18,PL30,45416,43672,1744,1744,0
2021-07-06,RA,17,PL35,0,0,288,288,0
2021-07-02,CL,14,PL45,294848,290560,3104,3104,0
2021-09-21,HO,18,PL01,64136,63336,800,800,0
2021-05-19,PRG,12,PL14,392096,391648,1184,1184,0
2021-10-31,CH,24,PL07,283486,279891,8502,4896,3606
2021-11-26,HO,18,PL10,68328,68320,128,128,0
2021-11-22,DI,19,PL52,0,0,0,0,0
2021-01-21,HO,18,PL09,72392,72152,240,240,0
2021-06-05,PB,25,PL55,444896,433056,12928,12928,0
2021-05-30,PB,25,PL54,449280,449664,768,768,0
2021-01-08,SD,13,PL21,64241,62469,3356,1584,1772
2021-08-02,EC,10,PL43,620496,619056,1584,1584,0
2021-10-31,CL,14,PL44,295392,294272,1632,1632,0
2021-07-22,SD,13,PL22,634,633,3,0,3
2021-10-29,CA,23,PL02,52920,49896,3024,3024,0
2021-05-08,SB,11,PL50,458752,457728,1504,1504,0
2021-05-16,CH,24,PL57,29400,29340,92,92,0
2021-12-10,EC,10,PL43,623328,622320,720,720,0
2021-02-18,EC,10,PL43,626016,625968,528,528,0
2021-02-15,HO,18,PL09,71256,71016,240,240,0
2021-06-26,CA,23,PL31,222312,220416,2352,2352,0
2021-01-30,RA,17,PL35,222072,220248,1848,1848,0
2021-11-10,SD,13,PL17,70254,70067,381,192,189
2021-05-09,HO,18,PL10,57088,57008,96,96,0
2021-10-09,HO,18,PL09,68560,68560,0,0,0
2021-10-19,CL,14,PL45,182176,164416,24256,24256,0
2021-04-14,HO,18,PL32,42904,42832,72,72,0
2021-08-01,HO,18,PL30,54632,54584,96,96,0
2021-10-16,PR,15,PL04,264448,263840,992,992,0
2021-08-23,CH,24,PL12,140704,139632,1200,1200,0
2021-08-02,HO,18,PL09,72584,72504,112,112,0
2021-09-11,CL,14,PL45,252000,247040,4032,4032,0
2021-08-24,HO,18,PL03,65640,65464,176,176,0
2021-11-02,CH,24,PL24,164192,163552,832,832,0
2021-05-12,PB,25,PL54,243104,199776,43776,43776,0
2021-01-14,RT,21,PL06,209736,209472,264,264,0
2021-06-16,HO,18,PL10,56112,55904,208,208,0
2021-06-07,PR,15,PL12,138320,138000,464,464,0
2021-06-18,CL,14,PL44,300416,294816,5312,5312,0
2021-09-14,PRG,12,PL14,388512,380992,7520,7520,0
2021-09-30,RT,21,PL41,90672,24800,67184,67184,0
2021-03-09,DI,19,PL52,293984,293600,1504,1504,0
2021-05-11,RT,21,PL05,26064,24960,1104,1104,0
2021-08-14,HO,18,PL56,66208,66096,112,112,0
2021-02-27,SD,13,PL20,76522,76057,670,192,478
2021-09-16,HO,18,PL09,49208,48656,576,576,0
2021-11-20,SD,13,PL19,75943,75821,300,192,108
2021-01-12,HO,18,PL01,40616,40464,536,536,0
2021-10-12,HO,18,PL40,0,0,344,344,0
2021-10-13,PR,15,PL24,267360,267232,416,416,0
2021-04-26,RA,17,PL35,15312,15120,9336,9336,0
2021-09-15,DI,19,PL53,219296,217152,2624,2624,0
2021-09-04,PB,25,PL54,420960,421312,16416,16416,0
2021-12-02,HO,18,PL10,68784,68592,96,96,0
2021-07-31,HO,18,PL11,64904,64824,120,120,0
2021-06-26,CH,24,PL07,288741,273743,20134,4704,15430
2021-08-18,HO,18,PL09,0,0,0,0,0
2021-04-13,SD,13,PL21,2068,2061,13,0,13
2021-04-08,HO,18,PL03,65560,65432,120,120,0
2021-12-10,SD,13,PL22,74598,74477,886,688,198
2021-01-03,CL,14,PL44,296352,281376,7904,7904,0
2021-07-29,HO,18,PL40,66288,66288,0,0,0
2021-04-13,HO,18,PL30,66224,66224,0,0,0
2021-07-13,HO,18,PL33,66224,66224,0,0,0
2021-11-05,RT,21,PL41,176112,173120,3136,3136,0
2021-03-06,RA,17,PL34,222624,222600,336,336,0
2021-10-28,HO,18,PL03,66792,66704,88,88,0
2021-12-03,HO,18,PL32,56936,56904,96,96,0
2021-11-06,RT,21,PL42,185696,182432,3296,3296,0
2021-12-05,PR,15,PL04,241344,241024,512,512,0
2021-06-03,CA,23,PL11,231792,229560,2760,2760,0
2021-07-11,CL,14,PL45,276544,271360,4576,4576,0
2021-06-26,HO,18,PL03,67600,67600,0,0,0
2021-02-17,RA,17,PL35,214872,208896,6696,6696,0
2021-07-04,HO,18,PL40,62544,62096,448,448,0
2021-07-26,PR,15,PL12,137008,136944,1152,1152,0
2021-08-15,HO,18,PL01,66880,65664,1256,1256,0
2021-01-08,CA,23,PL02,238512,235584,3216,3216,0
2021-04-14,RA,17,PL35,172056,170376,2664,2664,0
2021-06-04,PR,15,PL24,264416,263488,1376,1376,0
2021-09-27,SD,13,PL20,27752,26948,7969,7152,817
2021-06-10,CH,24,PL57,19944,19936,8,8,0
2021-04-21,SD,13,PL25,72888,72764,389,176,213
2021-11-26,CA,23,PL31,146736,145560,1944,1944,0
2021-06-16,CL,14,PL45,268608,253952,13344,13344,0
2021-02-13,SD,13,PL21,72303,70360,2330,368,1962
2021-10-19,PW,26,PL37,198240,196896,1344,1344,0
2021-03-08,SD,13,PL25,57703,57440,1386,1104,282
2021-05-04,EC,10,PL43,40144,29200,5232,5232,0
2021-08-25,SD,13,PL25,42663,42387,1108,832,276
2021-07-03,SD,13,PL17,70182,68524,3016,1344,1672
2021-10-22,SB,11,PL50,450656,446912,4576,4576,0
2021-11-23,SD,13,PL20,76461,76337,300,176,124
2021-06-24,HO,18,PL32,68600,68600,0,0,0
2021-04-24,SD,13,PL22,74919,74206,1081,368,713
2021-07-22,RA,17,PL34,169608,169320,3744,3744,0
2021-06-26,HO,18,PL09,72632,72544,88,88,0
2021-02-28,SD,13,PL20,74977,74619,902,544,358
2021-02-03,SD,13,PL17,68344,67215,1721,544,1177
2021-02-08,HO,18,PL11,54864,54632,232,232,0
2021-12-17,PR,15,PL04,264192,263712,1024,1024,0
2021-01-08,EC,10,PL43,120480,106368,22416,22416,0
2021-02-16,EC,10,PL43,483984,457536,5088,5088,0
2021-05-21,HO,18,PL03,63960,63672,304,304,0
2021-06-05,PR,15,PL24,268256,267136,1120,1120,0
2021-05-11,SD,13,PL21,61184,60756,923,464,459
2021-06-29,NT,16,PL51,506240,505952,1824,1824,0
2021-09-09,SD,13,PL22,76665,76670,228,176,52
2021-09-19,DI,19,PL52,289856,290336,384,384,0
2021-10-17,HO,18,PL03,67440,67376,88,88,0
2021-10-16,SD,13,PL21,64378,64155,621,384,237
2021-01-27,HO,18,PL10,55488,55160,328,328,0
2021-06-22,HO,18,PL03,67632,67472,160,160,0
2021-07-11,PB,25,PL55,448864,448992,640,640,0
2021-06-27,SD,13,PL18,61137,60499,2894,2208,686
2021-08-03,HO,18,PL09,73160,73160,0,0,0
2021-04-06,DI,19,PL53,283232,281728,1664,1664,0
2021-05-23,PB,25,PL55,449856,449792,1152,1152,0
2021-05-08,PR,15,PL04,262048,262048,832,832,0
2021-12-19,CH,24,PL12,164336,164128,208,208,0
2021-06-24,SD,13,PL21,71555,71114,825,384,441
2021-10-08,HO,18,PL09,67656,67640,152,152,0
2021-10-10,CA,23,PL13,67536,67536,256,256,0
2021-09-21,RA,17,PL35,187992,186696,5160,5160,0
2021-10-12,PR,15,PL04,254304,237760,16864,16864,0
2021-01-27,RA,17,PL34,191328,185592,5736,5736,0
2021-02-22,HO,18,PL11,59688,59544,144,144,0
2021-03-08,SD,13,PL20,5445,5432,13,0,13
2021-05-03,PW,26,PL37,95520,75168,20352,20352,0
2021-05-25,NT,16,PL51,437120,433024,4288,4288,0
2021-04-01,PB,25,PL54,231328,230592,736,736,0
2021-09-03,CA,23,PL31,230808,228744,2328,2328,0
2021-07-20,PW,26,PL37,817728,814752,3504,3504,0
2021-06-12,PB,25,PL54,442048,442048,704,704,0
2021-08-13,HO,18,PL11,66200,66232,0,0,0
2021-12-04,HO,18,PL10,68296,68112,336,336,0
2021-01-26,RT,21,PL05,204696,204744,480,480,0
2021-01-23,SD,13,PL20,75528,75407,350,208,142
2021-07-15,CA,23,PL11,0,0,232,232,0
2021-09-12,SB,11,PL36,298152,296112,2376,2376,0
2021-03-12,SD,13,PL20,73021,72253,1187,432,755
2021-12-06,SD,13,PL17,17599,17501,1555,1440,115
2021-07-27,HO,18,PL03,65696,65280,584,584,0
2021-09-17,SD,13,PL20,74081,74004,261,176,85
2021-06-11,CH,24,PL57,34240,34228,44,44,0
2021-12-19,PR,15,PL04,263552,261408,2464,2464,0
2021-06-26,SD,13,PL18,53077,48839,4537,176,4361
2021-04-30,HO,18,PL01,66192,65880,312,312,0
2021-09-29,HO,18,PL09,64840,64808,144,144,0
2021-05-03,SD,13,PL21,68389,67879,918,368,550
2021-01-25,RT,21,PL06,204792,204048,744,744,0
2021-12-02,HO,18,PL40,65872,65336,536,536,0
2021-12-08,PRG,12,PL14,197504,196064,1440,1440,0
2021-02-07,DI,19,PL52,269248,266784,2656,2656,0
2021-08-16,PR,15,PL24,265376,265312,448,448,0
2021-11-22,PB,25,PL54,0,0,1760,1760,0
2021-05-24,PW,26,PL37,0,0,0,0,0
2021-02-26,DI,19,PL52,298368,297760,1056,1056,0
2021-10-08,SD,13,PL19,71883,71729,870,608,262
2021-03-17,HO,18,PL11,66264,66264,0,0,0
2021-09-05,HO,18,PL40,62600,62544,272,272,0
2021-11-18,PR,15,PL04,264736,265088,384,384,0
2021-02-23,PB,25,PL55,448000,446624,1952,1952,0
2021-05-01,CH,24,PL07,299199,290296,19879,10976,8903
2021-05-26,SD,13,PL21,72126,71843,961,576,385
2021-05-25,CH,24,PL07,251488,222929,37391,8832,28559
2021-02-01,SD,13,PL17,58170,55693,6461,3984,2477
2021-10-14,EC,10,PL43,619104,618384,1248,1248,0
2021-11-11,CL,14,PL45,285792,278560,3488,3488,0
2021-05-30,SB,11,PL50,443168,439136,4928,4928,0
2021-07-01,HO,18,PL10,55520,55496,88,88,0
2021-09-03,SD,13,PL20,47964,47250,2060,1344,716
2021-09-11,HO,18,PL01,66208,64912,1320,1320,0
2021-01-05,EC,10,PL43,164848,164016,752,752,0
2021-01-03,CH,24,PL57,34180,34132,48,48,0
2021-05-15,CA,23,PL02,229896,226824,3912,3912,0
2021-10-23,SD,13,PL25,76170,75529,817,176,641
2021-12-17,SD,13,PL25,72858,72070,1110,256,854
2021-09-23,HO,18,PL33,132528,132528,0,0,0
2021-09-01,RT,21,PL41,68960,64000,5088,5088,0
2021-10-06,SD,13,PL25,72395,71504,1532,752,780
2021-08-20,HO,18,PL03,66792,66704,88,88,0
2021-02-04,SD,13,PL19,62432,61640,1160,368,792
2021-06-02,HO,18,PL09,70624,70552,224,224,0
2021-02-14,HO,18,PL11,66280,66280,0,0,0
2021-01-28,PRG,12,PL14,368960,348544,20864,20864,0
2021-10-14,PR,15,PL24,16736,16736,0,0,0
2021-12-01,PB,25,PL55,448160,448032,1120,1120,0
2021-10-14,CA,23,PL13,84960,85112,96,96,0
2021-12-22,NT,16,PL57,510688,509952,960,960,0
2021-05-25,CH,24,PL12,147008,146112,960,960,0
2021-10-31,HO,18,PL56,66112,66056,104,104,0
2021-12-13,PRG,12,PL14,389472,387584,2240,2240,0
2021-06-29,CH,24,PL08,107368,87770,25774,6176,19598
2021-06-19,HO,18,PL09,71752,71616,136,136,0
2021-01-11,PB,25,PL55,438464,419744,21504,21504,0
2021-03-11,CA,23,PL31,231888,231672,360,360,0
2021-09-03,PRG,12,PL14,389184,386784,3168,3168,0
2021-03-15,HO,18,PL01,66088,65560,528,528,0
2021-11-13,HO,18,PL01,57368,56960,408,408,0
2021-02-04,CA,23,PL02,172848,168576,4344,4344,0
2021-01-10,EC,10,PL43,280176,278256,2016,2016,0
2021-04-30,HO,18,PL33,65384,65344,152,152,0
2021-07-21,HO,18,PL56,55016,54832,392,392,0
2021-05-12,SD,13,PL20,25022,24964,426,368,58
2021-04-30,RA,17,PL34,218712,218712,0,0,0
2021-10-17,PB,25,PL54,444864,441472,5216,5216,0
2021-03-10,SB,11,PL50,455296,452320,3264,3264,0
2021-04-07,CL,14,PL45,277568,273888,1632,1632,0
2021-08-30,RT,21,PL05,207000,206304,1032,1032,0
2021-10-31,RT,21,PL06,201768,199104,3024,3024,0
2021-09-11,SD,13,PL20,62680,62664,2571,2528,43
2021-11-03,CH,24,PL57,34096,34096,56,56,0
2021-12-14,DI,19,PL53,183488,178336,5152,5152,0
2021-11-05,SD,13,PL17,67315,67083,984,752,232
2021-08-14,CH,24,PL08,148598,139157,27781,2688,25093
2021-11-08,CA,23,PL31,179448,176448,4248,4248,0
2021-06-08,SD,13,PL25,37609,37299,4452,4128,324
2021-05-24,RT,21,PL42,180640,176256,6288,6288,0
2021-08-27,SD,13,PL19,69539,69511,220,176,44
2021-01-21,HO,18,PL11,66280,66280,0,0,0
2021-04-09,SD,13,PL19,74295,74335,250,176,74
2021-12-05,DI,19,PL52,145440,145184,448,448,0
2021-11-05,SD,13,PL25,61848,60595,2665,1392,1273
2021-10-22,RT,21,PL42,4672,0,4672,4672,0
2021-07-27,RT,21,PL42,167136,164032,3632,3632,0
2021-10-22,PW,26,PL37,787152,783360,4512,4512,0
2021-03-24,CL,14,PL44,171808,169280,3904,3904,0
2021-03-08,HO,18,PL11,66288,66288,0,0,0
2021-10-01,CA,23,PL31,202200,197712,4704,4704,0
2021-08-16,CH,24,PL08,98698,82477,17533,1312,16221
2021-10-11,RT,21,PL41,20496,16,20480,20480,0
2021-09-25,CH,24,PL12,164112,163904,304,304,0
2021-12-02,EC,10,PL43,559440,554112,8448,8448,0
2021-08-01,HO,18,PL11,66272,66272,0,0,0
2021-09-22,SD,13,PL18,74393,74118,945,624,321
2021-09-20,PR,15,PL04,197888,195424,2464,2464,0
2021-09-26,SD,13,PL22,73596,73512,260,176,84
2021-10-14,SD,13,PL18,75578,75249,800,416,384
2021-09-11,CL,14,PL44,304480,302656,1824,1824,0
2021-04-15,SD,13,PL20,2462,2305,221,64,157
2021-05-22,HO,18,PL33,61104,61088,120,120,0
2021-08-17,RA,17,PL34,56448,56448,0,0,0
2021-02-12,CL,14,PL44,305632,296288,1312,1312,0
2021-09-18,NT,16,PL51,513152,514048,384,384,0
2021-05-27,HO,18,PL30,66136,66136,0,0,0
2021-10-01,SD,13,PL19,70952,68929,2386,352,2034
2021-05-13,CH,24,PL07,303459,290743,16012,3296,12716
2021-01-25,SD,13,PL18,72986,72806,372,192,180
2021-06-19,DI,19,PL53,295520,292800,3008,3008,0
2021-02-09,DI,19,PL52,279776,279552,576,576,0
2021-06-06,EC,10,PL43,629952,629424,576,576,0
2021-06-03,SD,13,PL25,55598,55262,688,352,336
2021-10-17,SD,13,PL20,75148,75046,310,208,102
2021-12-07,CH,24,PL07,130797,129667,3306,2176,1130
2021-05-27,CA,23,PL31,192912,192744,1152,1152,0
2021-11-06,SD,13,PL20,75696,75598,450,352,98
2021-06-06,HO,18,PL09,71408,71224,224,224,0
2021-05-22,DI,19,PL53,234752,233184,1952,1952,0
2021-02-07,HO,18,PL03,66216,66216,0,0,0
2021-04-08,HO,18,PL30,66208,66208,0,0,0
2021-04-28,CH,24,PL08,277422,254113,26531,2976,23555
2021-07-29,HO,18,PL03,66744,66560,416,416,0
2021-12-17,PB,25,PL54,305568,300032,22368,22368,0
2021-07-18,CL,14,PL44,300672,299200,992,992,0
2021-11-14,HO,18,PL11,66200,66280,0,0,0
2021-10-19,CA,23,PL31,183936,182520,2112,2112,0
2021-06-29,HO,18,PL10,55552,55496,200,200,0
2021-02-03,HO,18,PL30,65152,65176,96,96,0
2021-12-04,CH,24,PL08,302078,295501,16529,9952,6577
2021-12-01,CH,24,PL08,67152,64061,4179,1088,3091
2021-01-22,RT,21,PL06,205944,205224,720,720,0
2021-02-08,DI,19,PL52,295424,294880,640,640,0
2021-12-09,HO,18,PL11,65576,65248,360,360,0
2021-02-23,SD,13,PL25,25680,25659,662,640,22
2021-10-20,DI,19,PL53,298240,298048,352,352,0
2021-01-28,HO,18,PL11,60160,59560,600,600,0
2021-02-15,RA,17,PL56,217032,214728,2760,2760,0
2021-10-04,CA,23,PL13,61744,60192,1928,1928,0
2021-03-03,CH,24,PL04,91072,90240,992,992,0
2021-03-30,SB,11,PL50,458272,457088,2368,2368,0
2021-06-21,PB,25,PL55,447648,447200,1856,1856,0
2021-11-19,SD,13,PL22,68559,68524,889,832,57
2021-09-03,HO,18,PL10,68512,68424,88,88,0
2021-07-05,SD,13,PL17,71379,70268,3879,2768,1111
2021-05-22,CL,14,PL44,279584,278112,1344,1344,0
2021-09-04,HO,18,PL10,68368,68344,96,96,0
2021-05-17,SD,13,PL18,49126,48980,2882,2704,178
2021-05-25,CA,23,PL13,81096,80088,1104,1104,0
2021-06-18,PRG,12,PL14,390528,390560,1312,1312,0
2021-02-22,RT,21,PL05,205440,205368,264,264,0
2021-03-05,PW,26,PL37,813888,814320,1680,1680,0
2021-03-06,SD,13,PL25,73941,73937,319,288,31
2021-09-29,RT,21,PL41,176416,170336,6288,6288,0
2021-07-23,CA,23,PL11,0,0,176,176,0
2021-08-29,PRG,12,PL14,388544,387200,2304,2304,0
2021-09-23,CL,14,PL44,274144,238624,9760,9760,0
2021-04-30,HO,18,PL10,25584,24904,680,680,0
2021-01-26,SD,13,PL17,73009,72692,543,208,335
2021-10-07,PRG,12,PL14,377376,376768,3872,3872,0
2021-12-07,RT,21,PL06,206136,203304,3048,3048,0
2021-06-21,RT,21,PL06,179664,177480,4920,4920,0
2021-05-01,NT,16,PL51,464768,463264,2080,2080,0
2021-12-05,CH,24,PL08,204008,196725,15031,7648,7383
2021-07-11,CA,23,PL11,231024,229608,1776,1776,0
2021-02-18,DI,19,PL52,296544,296288,352,352,0
2021-04-07,DI,19,PL53,292448,290624,1920,1920,0
2021-03-30,HO,18,PL32,68000,68000,96,96,0
2021-04-30,SB,11,PL50,0,0,0,0,0
2021-06-03,CL,14,PL45,299648,292416,2592,2592,0
2021-09-24,HO,18,PL10,68096,68080,112,112,0
2021-09-02,CA,23,PL13,82608,82344,384,384,0
2021-10-05,PB,25,PL54,112064,104448,7616,7616,0
2021-04-11,HO,18,PL11,66152,65976,176,176,0
2021-04-11,PR,15,PL04,262944,262848,640,640,0
2021-07-29,HO,18,PL33,65984,65376,608,608,0
2021-07-30,RA,17,PL34,220248,220080,456,456,0
2021-10-08,CL,14,PL44,298176,277984,3168,3168,0
2021-06-13,HO,18,PL33,131296,131088,208,208,0
2021-01-30,HO,18,PL32,67632,67464,176,176,0
2021-03-27,CL,14,PL44,276864,269248,1568,1568,0
2021-05-30,HO,18,PL33,131680,131392,288,288,0
2021-04-03,HO,18,PL03,30096,29808,288,288,0
2021-11-27,DI,19,PL53,293504,291328,2720,2720,0
2021-12-07,CA,23,PL02,232728,230400,2592,2592,0
2021-06-02,PB,25,PL55,435680,432608,5728,5728,0
2021-06-25,PB,25,PL54,131008,108480,23232,23232,0
2021-01-05,HO,18,PL30,62472,62184,288,288,0
2021-12-02,PRG,12,PL14,392352,391808,1024,1024,0
2021-01-19,HO,18,PL01,11488,9096,2392,2392,0
2021-06-03,HO,18,PL40,65520,65400,120,120,0
2021-10-12,SD,13,PL20,55041,54609,2848,2416,432
2021-02-10,CL,14,PL44,218880,213312,736,736,0
2021-11-08,PRG,12,PL14,312416,312096,896,896,0
2021-11-02,PW,26,PL37,803328,798432,6432,6432,0
2021-12-05,RA,17,PL56,258072,257112,1320,1320,0
2021-04-07,PRG,12,PL14,391776,391808,896,896,0
2021-03-28,PR,15,PL24,264480,263904,576,576,0
2021-07-19,HO,18,PL30,66216,66216,0,0,0
2021-09-30,CL,14,PL45,272768,258784,13120,13120,0
2021-10-28,CA,23,PL02,232992,232488,720,720,0
2021-10-15,SB,11,PL50,460384,459808,1760,1760,0
2021-06-16,CL,14,PL44,243936,241056,2592,2592,0
2021-09-11,SB,11,PL36,307488,306120,1368,1368,0
2021-09-01,RT,21,PL06,168744,164016,4728,4728,0
2021-08-29,HO,18,PL10,68184,68224,88,88,0
2021-05-26,CH,24,PL07,24427,22590,10264,1984,8280
2021-12-01,RT,21,PL06,205416,205536,288,288,0
2021-04-24,SD,13,PL19,74910,74883,825,784,41
2021-05-31,CA,23,PL13,84432,84280,264,264,0
2021-06-13,SD,13,PL17,75901,75165,1180,368,812
2021-10-10,HO,18,PL09,67384,67400,96,96,0
2021-11-13,RA,17,PL35,224280,223104,1368,1368,0
2021-10-22,NT,16,PL51,484448,483904,1696,1696,0
2021-03-26,PW,26,PL37,179808,179136,672,672,0
2021-10-23,RA,17,PL35,264960,263472,1488,1488,0
2021-01-18,SB,11,PL36,311928,309888,3312,3312,0
2021-07-27,CA,23,PL31,0,0,1968,1968,0
2021-04-27,CA,23,PL31,153792,151968,2304,2304,0
2021-05-19,SD,13,PL18,51317,50713,2140,1536,604
2021-04-26,RA,17,PL34,14088,12000,2352,2352,0
2021-06-02,CA,23,PL31,179832,178272,2520,2520,0
2021-05-12,SD,13,PL21,64983,64572,603,192,411
2021-08-29,CH,24,PL08,193907,189315,13190,7360,5830
2021-06-06,PR,15,PL12,136176,135648,624,624,0
2021-11-19,CH,24,PL08,0,0,1600,1600,0
2021-09-22,SD,13,PL21,61043,60694,1405,1040,365
2021-04-28,SD,13,PL20,72069,71914,1211,1056,155
2021-01-27,SD,13,PL21,57976,56461,3531,2016,1515
2021-06-24,HO,18,PL09,72424,72240,184,184,0
2021-11-26,HO,18,PL32,48000,47520,512,512,0
2021-12-08,HO,18,PL32,56248,56128,184,184,0
2021-06-28,PR,15,PL24,264544,264640,384,384,0
2021-06-17,HO,18,PL32,66760,66472,328,328,0
2021-11-07,PRG,12,PL14,389440,388448,2144,2144,0
2021-03-11,PR,15,PL24,262784,262272,768,768,0
2021-02-11,HO,18,PL11,66288,66288,0,0,0
2021-10-10,NT,16,PL51,511840,511968,864,864,0
2021-05-01,RA,17,PL56,218328,217128,1464,1464,0
2021-06-04,CA,23,PL11,182184,179640,3168,3168,0
2021-06-08,RA,17,PL34,170808,168120,2688,2688,0
2021-07-20,CL,14,PL45,292224,287200,3872,3872,0
2021-05-26,HO,18,PL01,66840,66240,592,592,0
2021-09-19,CH,24,PL08,273338,267493,16483,7200,9283
2021-09-28,RA,17,PL34,250320,242544,7920,7920,0
2021-01-25,PRG,12,PL14,287136,285568,2112,2112,0
2021-10-30,SD,13,PL25,46956,46336,2838,2128,710
2021-02-26,CH,24,PL12,137920,128384,9824,9824,0
2021-06-03,RT,21,PL05,209736,209952,24,24,0
2021-02-08,SD,13,PL22,72266,72168,392,208,184
2021-06-12,RT,21,PL06,0,0,3096,3096,0
2021-06-17,CA,23,PL31,231768,224904,7248,7248,0
2021-04-13,PB,25,PL55,404640,390048,15680,15680,0
2021-11-06,PB,25,PL54,412128,397824,14240,14240,0
2021-04-21,CA,23,PL02,229248,229080,1224,1224,0
2021-06-04,DI,19,PL53,298560,298304,416,416,0
2021-10-24,SD,13,PL22,74354,74232,734,624,110
2021-11-07,PW,26,PL37,787200,778896,10704,10704,0
2021-12-22,PR,15,PL24,228480,228160,416,416,0
2021-04-11,RA,17,PL56,218352,215952,2400,2400,0
2021-06-30,SB,11,PL36,161064,153240,8352,8352,0
2021-10-20,HO,18,PL56,66192,66080,112,112,0
2021-10-21,CA,23,PL02,234600,234120,624,624,0
2021-09-25,PW,26,PL37,800016,798912,3216,3216,0
2021-06-21,PW,26,PL37,815376,813312,3648,3648,0
2021-01-03,CA,23,PL13,51064,50616,856,856,0
2021-12-03,HO,18,PL40,66248,66160,88,88,0
2021-04-06,CH,24,PL08,75412,58599,17299,192,17107
2021-09-30,EC,10,PL43,590832,579552,14112,14112,0
2021-09-01,DI,19,PL52,133664,133536,2112,2112,0
2021-12-12,DI,19,PL52,282976,281888,1312,1312,0
2021-03-04,PR,15,PL24,262336,262208,768,768,0
2021-11-14,PW,26,PL37,783744,786336,3552,3552,0
2021-09-13,HO,18,PL09,63280,63008,272,272,0
2021-07-13,HO,18,PL09,72464,72416,96,96,0
2021-08-14,SB,11,PL36,295488,285264,10224,10224,0
2021-12-14,SB,11,PL36,294840,289320,5712,5712,0
2021-06-13,HO,18,PL09,68944,68920,88,88,0
2021-06-21,SD,13,PL21,66194,65694,1739,1232,507
2021-04-27,CH,24,PL08,0,0,608,608,0
2021-04-24,HO,18,PL03,66296,66296,0,0,0
2021-12-07,SD,13,PL17,23972,22276,7904,6208,1696
2021-11-28,SD,13,PL25,58684,57417,1884,592,1292
2021-09-08,HO,18,PL33,132272,132464,0,0,0
2021-03-21,HO,18,PL32,65432,65344,88,88,0
2021-12-13,CA,23,PL35,78864,78872,80,80,0
2021-12-10,HO,18,PL11,65296,64976,368,368,0
2021-07-17,CL,14,PL45,292544,285984,4928,4928,0
2021-12-11,CH,24,PL08,29395,21944,14427,6976,7451
2021-02-16,PRG,12,PL14,393920,393504,896,896,0
2021-08-13,SB,11,PL36,307680,305808,2040,2040,0
2021-10-08,PB,25,PL55,444032,426816,18176,18176,0
2021-11-26,SD,13,PL25,74722,73447,1308,0,1308
2021-10-01,RA,17,PL34,261072,257808,3720,3720,0
2021-04-26,PR,15,PL57,141216,141136,176,176,0
2021-06-30,HO,18,PL40,66344,66328,16,16,0
2021-10-07,CL,14,PL45,270432,260128,5888,5888,0
2021-04-27,SD,13,PL18,70248,69802,818,352,466
2021-04-20,PR,15,PL04,261600,261024,960,960,0
2021-08-11,HO,18,PL56,65912,65680,272,272,0
2021-01-11,DI,19,PL53,0,0,2304,2304,0
2021-01-19,CL,14,PL44,186464,161376,6976,6976,0
2021-12-14,PR,15,PL04,262944,262240,960,960,0
2021-06-09,SB,11,PL50,375488,374880,5792,5792,0
2021-07-31,CH,24,PL08,307249,304482,12094,8992,3102
2021-06-09,CH,24,PL08,125906,123369,5833,3296,2537
2021-10-31,PB,25,PL55,411616,381472,32480,32480,0
2021-11-22,CH,24,PL57,33676,33672,44,44,0
2021-03-12,HO,18,PL11,66280,66280,0,0,0
2021-07-16,CA,23,PL02,232872,232824,312,312,0
2021-01-24,CH,24,PL57,34276,34268,44,44,0
2021-07-15,SD,13,PL17,67042,65624,2017,544,1473
2021-10-11,CA,23,PL02,130128,130104,1488,1488,0
2021-08-16,HO,18,PL11,10552,10552,0,0,0
2021-07-30,CH,24,PL08,305789,301532,8109,3808,4301
2021-07-11,HO,18,PL30,64016,63984,112,112,0
2021-04-29,HO,18,PL03,53840,53352,3760,3760,0
2021-12-02,DI,19,PL52,282784,282400,992,992,0
2021-08-20,HO,18,PL01,66944,66256,640,640,0
2021-02-13,CH,24,PL04,164000,163616,448,448,0
2021-06-06,DI,19,PL52,291712,290080,1920,1920,0
2021-02-18,NT,16,PL51,460128,458592,3264,3264,0
2021-03-30,CA,23,PL13,85168,85208,112,112,0
2021-07-02,HO,18,PL03,65728,65584,192,192,0
2021-11-25,PR,15,PL04,262688,262816,352,352,0
2021-06-28,CH,24,PL08,244799,242794,5109,3104,2005
2021-05-03,CL,14,PL45,166848,129664,11904,11904,0
2021-09-12,SD,13,PL21,75006,74699,780,448,332
2021-09-02,SB,11,PL36,255792,252552,8664,8664,0
2021-06-20,HO,18,PL32,67352,67248,256,256,0
2021-05-21,RA,17,PL56,182712,176544,11952,11952,0
2021-06-01,SD,13,PL19,69137,69102,1684,1600,84
2021-07-27,HO,18,PL32,67904,67768,136,136,0
2021-10-11,SD,13,PL18,74168,73740,796,368,428
2021-12-02,SD,13,PL20,72541,72058,846,320,526
2021-11-04,SD,13,PL21,64488,64320,156,0,156
2021-09-16,HO,18,PL56,66144,65912,232,232,0
2021-08-14,CA,23,PL31,119952,119544,1224,1224,0
2021-03-16,RT,21,PL06,202032,198120,4128,4128,0
2021-05-01,CA,23,PL11,223128,218064,5304,5304,0
2021-10-13,SD,13,PL25,73422,72972,1288,752,536
2021-02-10,EC,10,PL43,606720,605376,1152,1152,0
2021-05-24,RA,17,PL35,0,0,0,0,0
2021-02-21,DI,19,PL53,271360,269408,1984,1984,0
2021-02-28,HO,18,PL09,72096,72008,88,88,0
2021-09-26,EC,10,PL43,356256,333696,21312,21312,0
2021-11-06,CH,24,PL07,306803,303644,6214,2592,3622
2021-06-18,HO,18,PL30,65112,65112,96,96,0
2021-01-18,HO,18,PL32,33960,33800,1592,1592,0
2021-01-08,CH,24,PL08,276189,264929,19388,8128,11260
2021-07-25,CH,24,PL08,262749,251966,21911,10624,11287
2021-05-31,DI,19,PL52,275328,274848,2176,2176,0
2021-08-04,SD,13,PL19,0,0,78,0,78
2021-06-17,CA,23,PL02,234720,234432,528,528,0
2021-07-02,HO,18,PL30,60800,60696,216,216,0
2021-10-01,SD,13,PL18,75001,74260,1345,560,785
2021-04-19,HO,18,PL03,37440,37440,96,96,0
2021-12-09,CA,23,PL02,234744,233952,1128,1128,0
2021-09-07,CH,24,PL08,209896,206683,6144,2112,4032
2021-10-21,SD,13,PL22,41301,41230,1676,1216,460
2021-02-16,HO,18,PL33,66072,64768,1304,1304,0
2021-05-25,HO,18,PL09,71216,71048,224,224,0
2021-01-19,CA,23,PL13,53944,53872,152,152,0
2021-11-20,SD,13,PL22,73712,73626,294,208,86
2021-12-19,CA,23,PL13,85624,85424,232,232,0
2021-10-04,HO,18,PL32,56520,56504,128,128,0
2021-03-01,SD,13,PL19,75620,75184,951,416,535
2021-05-26,SD,13,PL17,60860,60100,1816,1056,760
2021-04-11,PR,15,PL24,264736,263808,928,928,0
2021-01-13,SD,13,PL20,8005,4243,7794,4032,3762
2021-07-02,PB,25,PL55,435296,432832,3040,3040,0
2021-05-20,SD,13,PL20,58154,58084,3977,3808,169
2021-05-30,CA,23,PL02,225936,222816,3624,3624,0
2021-01-02,HO,18,PL32,49016,49008,8,8,0
2021-02-27,SD,13,PL25,64774,64528,1606,1360,246
2021-02-11,PRG,12,PL12,392704,392608,832,832,0
2021-03-18,PB,25,PL55,444096,415936,29216,29216,0
2021-11-18,CL,14,PL44,89344,81696,8128,8128,0
2021-08-08,HO,18,PL01,65768,65408,360,360,0
2021-06-11,CL,14,PL44,60160,58528,3936,3936,0
2021-07-08,RT,21,PL05,205320,205416,384,384,0
2021-07-02,PRG,12,PL14,389184,386656,2528,2528,0
2021-03-15,SD,13,PL21,38538,38538,3040,3040,0
2021-01-07,SD,13,PL25,72274,71936,367,0,367
2021-04-30,SD,13,PL19,71431,71324,1883,1776,107
2021-09-29,DI,19,PL53,293312,293056,352,352,0
2021-02-10,CH,24,PL08,90944,90080,4576,4576,0
2021-09-10,CH,24,PL08,314563,310453,8748,4448,4300
2021-01-14,CA,23,PL02,233520,233208,1176,1176,0
2021-01-02,SD,13,PL20,44163,44015,884,736,148
2021-01-29,SD,13,PL20,11781,11751,5182,5152,30
2021-01-07,SB,11,PL36,240504,237480,3504,3504,0
2021-10-03,HO,18,PL33,132480,132480,0,0,0
2021-11-24,SD,13,PL18,71898,70845,2229,1120,1109
2021-06-08,PR,15,PL04,225344,223200,3072,3072,0
2021-08-04,SB,11,PL36,292200,288528,4176,4176,0
2021-10-09,SD,13,PL22,75927,75878,241,192,49
2021-03-14,DI,19,PL52,295200,289760,5504,5504,0
2021-10-13,SD,13,PL17,68693,68528,1509,1312,197
2021-04-08,HO,18,PL32,48984,48744,424,424,0
2021-01-17,HO,18,PL01,66272,66272,0,0,0
2021-08-02,CH,24,PL08,306413,303026,7355,3968,3387
2021-11-18,HO,18,PL11,66232,66232,0,0,0
2021-03-22,HO,18,PL03,66144,66184,0,0,0
2021-03-18,RA,17,PL56,166992,161040,7608,7608,0
2021-04-17,PRG,12,PL14,316320,316608,320,320,0
2021-04-26,RT,21,PL42,105392,41888,63504,63504,0
2021-05-13,PB,25,PL54,425408,404032,21696,21696,0
2021-06-11,HO,18,PL40,65560,65456,104,104,0
2021-01-13,CH,24,PL08,300950,294031,17831,10912,6919
2021-05-08,SD,13,PL19,74046,74047,1638,1600,38
2021-08-15,SD,13,PL19,68516,68421,1535,1440,95
2021-06-10,EC,10,PL43,635232,634704,1056,1056,0
2021-10-21,HO,18,PL11,63992,63680,312,312,0
2021-08-10,SD,13,PL19,70911,70639,2256,1984,272
2021-08-31,CH,24,PL08,222953,206449,20088,3584,16504
2021-02-17,HO,18,PL01,52360,51184,1176,1176,0
2021-07-01,SD,13,PL21,72849,72494,1283,928,355
2021-08-04,RT,21,PL42,166032,155488,10800,10800,0
2021-02-26,RA,17,PL35,198816,192048,6792,6792,0
2021-03-12,DI,19,PL52,199936,199616,320,320,0
2021-03-30,HO,18,PL11,66288,66288,0,0,0
2021-06-21,SD,13,PL17,70398,69968,1326,896,430
2021-06-26,PR,15,PL24,264512,264224,608,608,0
2021-07-30,CA,23,PL31,101376,99528,2952,2952,0
2021-12-10,CA,23,PL13,85328,85248,152,152,0
2021-02-24,HO,18,PL10,57144,56920,224,224,0
2021-10-02,RT,21,PL05,205704,205608,408,408,0
2021-11-27,SD,13,PL25,72483,71144,2140,800,1340
2021-12-22,SD,13,PL17,75932,75531,769,176,593
2021-07-15,HO,18,PL01,68288,68256,32,32,0
2021-09-01,CH,24,PL07,223491,222472,11948,9824,2124
2021-11-11,CA,23,PL13,84952,84968,88,88,0
2021-05-08,CA,23,PL11,230880,227808,3360,3360,0
2021-11-05,HO,18,PL01,67776,67728,88,88,0
2021-01-23,CA,23,PL02,232080,229968,2280,2280,0
2021-05-28,RA,17,PL34,220656,220032,624,624,0
2021-06-16,CA,23,PL31,230832,224616,6432,6432,0
2021-11-15,HO,18,PL40,65504,65424,104,104,0
2021-01-26,CH,24,PL08,175192,173048,9600,7456,2144
2021-06-23,PW,26,PL37,817632,814224,3984,3984,0
2021-10-30,RT,21,PL42,165568,161120,11072,11072,0
2021-12-08,CH,24,PL12,162928,162800,416,416,0
2021-08-16,PB,25,PL54,443936,443872,1728,1728,0
2021-09-01,HO,18,PL10,68560,68528,112,112,0
2021-07-01,SD,13,PL19,76125,76136,248,192,56
2021-01-03,DI,19,PL53,297408,296704,864,864,0
2021-01-06,SD,13,PL22,70534,70113,794,352,442
2021-07-30,SD,13,PL18,75188,74785,968,480,488
2021-10-08,RT,21,PL05,206400,206208,264,264,0
2021-04-06,EC,10,PL43,490992,457536,40272,40272,0
2021-02-12,RT,21,PL06,209688,209664,24,24,0
2021-11-18,HO,18,PL40,65192,64936,424,424,0
2021-04-06,CA,23,PL31,131736,117168,14712,14712,0
2021-05-07,CH,24,PL12,164672,164800,176,176,0
2021-11-25,SD,13,PL19,65249,64759,858,368,490
2021-03-21,HO,18,PL10,57696,57696,0,0,0
2021-07-14,HO,18,PL40,64904,64208,704,704,0
2021-01-05,DI,19,PL52,281216,279488,2080,2080,0
2021-06-17,CL,14,PL45,280736,273088,7008,7008,0
2021-10-07,CA,23,PL02,124296,124104,1392,1392,0
2021-02-21,SB,11,PL50,454816,453344,2240,2240,0
2021-08-15,CH,24,PL07,273150,259438,26616,12704,13912
2021-02-04,EC,10,PL43,617088,616032,1632,1632,0
2021-11-04,RT,21,PL42,186816,168752,18192,18192,0
2021-03-12,HO,18,PL33,32616,31592,1088,1088,0
2021-11-24,RT,21,PL42,183968,181712,2704,2704,0
2021-04-04,HO,18,PL11,65800,65632,176,176,0
2021-10-01,SD,13,PL20,74259,73558,877,176,701
2021-08-10,SD,13,PL25,70501,69752,1101,352,749
2021-04-23,PR,15,PL24,259200,253760,5728,5728,0
2021-04-26,SD,13,PL18,74087,73590,725,176,549
2021-06-07,SD,13,PL20,2143,2113,1013,464,549
2021-08-06,HO,18,PL56,65960,65040,920,920,0
2021-11-25,CA,23,PL13,74824,74944,240,240,0
2021-12-17,PW,26,PL37,811872,809904,4128,4128,0
2021-11-09,SD,13,PL25,63645,60788,3321,464,2857
2021-11-28,HO,18,PL09,66240,66240,0,0,0
2021-02-17,SB,11,PL36,303792,300240,3888,3888,0
2021-03-16,RT,21,PL05,206784,206712,264,264,0
2021-09-09,HO,18,PL03,58872,55464,3408,3408,0
2021-11-14,SD,13,PL25,70360,69604,1188,384,804
2021-10-18,SD,13,PL19,59095,58961,6366,6176,190
2021-06-06,HO,18,PL30,66128,66176,0,0,0
2021-03-26,RA,17,PL56,52968,52320,2376,2376,0
2021-09-13,NT,16,PL51,511424,510304,2752,2752,0
2021-04-05,HO,18,PL01,66272,66272,0,0,0
2021-07-17,RT,21,PL42,116592,113664,2944,2944,0
2021-10-30,HO,18,PL56,60264,59520,744,744,0
2021-10-02,PR,15,PL24,267040,265824,1216,1216,0
2021-05-11,SD,13,PL25,10361,10306,423,368,55
2021-11-03,HO,18,PL56,56464,56088,376,376,0
2021-01-10,PRG,12,PL12,394400,394112,704,704,0
2021-01-26,CA,23,PL31,172680,168432,4536,4536,0
2021-01-05,HO,18,PL33,64232,64080,184,184,0
2021-01-03,PRG,12,PL12,388736,387936,2560,2560,0
2021-12-21,NT,16,PL57,512960,512640,736,736,0
2021-01-30,SD,13,PL22,63215,62977,1014,736,278
2021-06-24,HO,18,PL01,49464,49240,2504,2504,0
2021-01-04,RT,21,PL06,165072,161136,3936,3936,0
2021-06-07,CL,14,PL44,57536,3008,1952,1952,0
2021-09-20,SD,13,PL18,76573,76344,245,16,229
2021-01-16,DI,19,PL52,295968,295616,864,864,0
2021-01-18,RT,21,PL05,204312,200880,3432,3432,0
2021-09-25,HO,18,PL01,68248,67800,448,448,0
2021-09-28,SB,11,PL36,287712,285792,1920,1920,0
2021-12-21,EC,10,PL43,627168,626592,576,576,0
2021-10-24,SD,13,PL25,67606,66552,2793,1664,1129
2021-10-26,CL,14,PL45,293920,288032,4512,4512,0
2021-03-24,NT,16,PL57,153264,153008,688,688,0
2021-02-07,HO,18,PL30,66080,66120,0,0,0
2021-03-30,SD,13,PL17,51151,49845,4724,2528,2196
2021-05-03,PR,15,PL57,70480,61776,8704,8704,0
2021-09-30,RT,21,PL05,197256,196728,528,528,0
2021-02-06,SB,11,PL50,417472,414752,3168,3168,0
2021-06-26,CH,24,PL08,276357,267549,18153,8960,9193
2021-03-17,CH,24,PL12,163808,163904,288,288,0
2021-03-23,NT,16,PL51,468480,467904,736,736,0
2021-04-22,SD,13,PL20,74908,74808,386,192,194
2021-09-13,CL,14,PL45,231040,217664,12704,12704,0
2021-11-22,NT,16,PL51,508192,507680,1120,1120,0
2021-05-27,SB,11,PL36,310584,308976,1752,1752,0
2021-07-02,HO,18,PL10,28056,28056,0,0,0
2021-02-11,PW,26,PL37,805296,803712,2784,2784,0
2021-03-05,DI,19,PL53,276608,275776,2880,2880,0
2021-05-11,RT,21,PL41,0,0,0,0,0
2021-06-13,SD,13,PL22,17109,15887,2198,976,1222
2021-11-10,HO,18,PL30,1040,96,944,944,0
2021-01-25,HO,18,PL10,48592,47736,856,856,0
2021-06-25,CA,23,PL11,234744,234000,1272,1272,0
2021-03-10,SD,13,PL19,66309,65733,2611,2032,579
2021-06-26,RT,21,PL42,174304,161840,12656,12656,0
2021-10-16,RA,17,PL34,197232,190320,6984,6984,0
2021-11-26,CH,24,PL24,104304,104112,688,688,0
2021-08-14,HO,18,PL01,67560,66272,1288,1288,0
2021-03-29,RT,21,PL05,32952,32688,480,480,0
2021-02-23,HO,18,PL11,59704,59608,96,96,0
2021-04-25,RA,17,PL35,216456,201168,15360,15360,0
2021-01-14,HO,18,PL32,0,0,152,152,0
2021-11-30,SD,13,PL22,70680,70572,670,576,94
2021-10-27,SD,13,PL17,70104,69615,841,352,489
2021-05-17,HO,18,PL09,72760,72728,88,88,0
2021-01-07,RT,21,PL06,209952,209952,0,0,0
2021-02-05,CL,14,PL44,305728,302720,544,544,0
2021-02-28,RT,21,PL05,167352,164352,3168,3168,0
2021-05-08,HO,18,PL09,70904,70768,136,136,0
2021-02-26,HO,18,PL10,57280,57184,96,96,0
2021-08-05,SD,13,PL20,75010,75020,668,608,60
2021-10-12,CL,14,PL45,240704,236128,4384,4384,0
2021-01-17,RT,21,PL06,206424,206208,432,432,0
2021-07-30,CL,14,PL45,287360,283200,3168,3168,0
2021-05-27,HO,18,PL33,82240,77728,7104,7104,0
2021-04-09,PW,26,PL37,569616,532224,38208,38208,0
2021-06-18,SD,13,PL17,24801,23503,4852,3488,1364
2021-10-06,HO,18,PL03,67000,66792,240,240,0
2021-06-19,CH,24,PL07,214496,200955,18597,5056,13541
2021-10-04,HO,18,PL56,63384,63208,288,288,0
2021-09-03,PB,25,PL55,0,0,11040,11040,0
2021-10-08,CA,23,PL02,230160,229920,528,528,0
2021-11-12,CH,24,PL07,112759,112032,15927,15200,727
2021-05-29,RT,21,PL06,203496,203304,408,408,0
2021-09-29,SB,11,PL50,457728,457024,1568,1568,0
2021-12-04,SD,13,PL25,48889,48188,1085,384,701
2021-11-02,CL,14,PL44,296320,294208,1792,1792,0
2021-01-12,HO,18,PL33,67488,67080,440,440,0
2021-02-10,SD,13,PL17,50241,49156,3501,2416,1085
2021-06-20,HO,18,PL10,56976,56648,328,328,0
2021-08-12,EC,10,PL43,627936,626592,1968,1968,0
2021-09-28,RT,21,PL41,164848,157648,7328,7328,0
2021-11-12,NT,16,PL51,510240,510208,320,320,0
2021-09-08,DI,19,PL52,217376,215360,2176,2176,0
2021-11-10,HO,18,PL40,47456,47128,328,328,0
2021-10-02,SB,11,PL36,311568,310344,2280,2280,0
2021-10-19,RT,21,PL05,202920,201168,2352,2352,0
2021-05-25,RA,17,PL34,214584,211440,3336,3336,0
2021-07-24,SD,13,PL19,38586,38207,3592,3168,424
2021-06-30,DI,19,PL53,294496,293440,1440,1440,0
2021-05-11,SD,13,PL20,75440,75152,720,432,288
2021-06-14,HO,18,PL30,66128,66152,0,0,0
2021-09-03,CL,14,PL44,0,0,2240,2240,0
2021-05-24,DI,19,PL52,0,0,0,0,0
2021-09-05,RA,17,PL35,131184,130872,288,288,0
2021-01-19,SD,13,PL21,70030,68415,1967,352,1615
2021-08-11,CL,14,PL44,237184,233536,5120,5120,0
2021-11-05,CL,14,PL44,300864,299136,1184,1184,0
2021-06-01,CH,24,PL57,31280,30964,312,312,0
2021-03-09,PB,25,PL55,428384,417120,12704,12704,0
2021-09-22,RT,21,PL06,208992,208584,408,408,0
2021-06-05,HO,18,PL33,123712,123584,512,512,0
2021-06-19,SD,13,PL19,67440,67409,1151,1120,31
2021-12-21,HO,18,PL11,66192,66192,0,0,0
2021-02-02,SD,13,PL19,24381,21684,7529,4832,2697
2021-03-25,PB,25,PL54,7296,4320,2976,2976,0
2021-05-06,RT,21,PL42,129344,120000,9344,9344,0
2021-03-31,CH,24,PL07,282174,277444,8946,4096,4850
2021-08-25,PR,15,PL24,254656,241536,13344,13344,0
2021-06-18,PB,25,PL55,445440,445792,1600,1600,0
2021-06-04,HO,18,PL01,51448,51176,272,272,0
2021-07-25,SD,13,PL25,55785,53628,3621,1424,2197
2021-09-25,HO,18,PL56,65888,64848,1040,1040,0
2021-11-14,PRG,12,PL14,392224,391744,1024,1024,0
2021-05-02,HO,18,PL33,66208,66208,0,0,0
2021-07-24,SD,13,PL18,47673,47445,900,672,228
2021-03-02,SD,13,PL25,69447,69437,300,208,92
2021-02-12,HO,18,PL09,72648,72560,88,88,0
2021-03-28,SD,13,PL21,57536,57321,1370,1088,282
2021-04-22,CA,23,PL13,84192,84184,1240,1240,0
2021-07-10,CA,23,PL11,232224,232200,840,840,0
2021-07-29,PB,25,PL55,0,0,1952,1952,0
2021-02-16,SD,13,PL25,73485,73457,268,240,28
2021-10-22,RA,17,PL34,163632,161616,3552,3552,0
2021-12-19,PB,25,PL55,449760,448800,1440,1440,0
